SNo,Month,Date,Country,RegionCode,RegionName,Latitude,Longitude,HospitalizedPatients,IntensiveCarePatients,TotalHospitalizedPatients,HomeConfinement,CurrentPositiveCases,NewPositiveCases,Recovered,Deaths,TotalPositiveCases,TestsPerformed
2058,6,1,ITA,13,Abruzzo,42.35122196,13.39843823,113,6,119,625,744,1,2093,408,3245,52646
2059,6,1,ITA,17,Basilicata,40.63947052,15.80514834,4,0,4,24,28,0,344,27,399,29196
2060,6,1,ITA,18,Calabria,38.90597598,16.59440194,20,1,21,114,135,0,926,97,1158,68633
2061,6,1,ITA,15,Campania,40.83956555,14.25084984,224,6,230,709,939,4,3454,413,4806,99580
2062,6,1,ITA,8,Emilia-Romagna,44.49436681,11.3417208,383,54,437,2631,3068,19,20617,4124,27809,198884
2063,6,1,ITA,6,Friuli Venezia Giulia,45.6494354,13.76813649,40,2,42,224,266,1,2673,335,3274,80085
2064,6,1,ITA,12,Lazio,41.89277044,12.48366722,594,56,650,2244,2894,10,4105,739,7738,208081
2065,6,1,ITA,7,Liguria,44.41149315,8.9326992,191,7,198,413,611,56,7641,1467,9719,60117
2066,6,1,ITA,3,Lombardia,45.46679409,9.190347404,3085,167,3252,17609,20861,50,52026,16131,89018,447874
2067,6,1,ITA,11,Marche,43.61675973,13.5188753,63,9,72,1255,1327,0,4416,987,6730,65848
2068,6,1,ITA,14,Molise,41.55774754,14.65916051,2,2,4,131,135,0,279,22,436,14147
2069,6,1,ITA,21,P.A. Bolzano,46.49933453,11.35662422,13,4,17,106,123,1,2184,291,2598,31254
2070,6,1,ITA,22,P.A. Trento,46.06893511,11.12123097,14,3,17,276,293,2,3677,462,4432,48853
2071,6,1,ITA,1,Piemonte,45.0732745,7.680687483,904,54,958,4104,5062,21,21720,3876,30658,209006
2072,6,1,ITA,16,Puglia,41.12559576,16.86736689,140,11,151,1004,1155,4,2837,506,4498,80390
2073,6,1,ITA,20,Sardegna,39.21531192,9.110616306,23,1,24,137,161,1,1065,131,1357,49354
2074,6,1,ITA,19,Sicilia,38.11569725,13.3623567,65,8,73,894,967,0,2202,274,3443,129103
2075,6,1,ITA,9,Toscana,43.76923077,11.25588885,85,25,110,972,1082,3,7977,1048,10107,180233
2076,6,1,ITA,10,Umbria,43.10675841,12.38824698,15,2,17,14,31,0,1324,76,1431,50790
2077,6,1,ITA,2,Valle d'Aosta,45.73750286,7.320149366,11,0,11,6,17,3,1027,143,1187,11950
2078,6,1,ITA,5,Veneto,45.43490485,12.33845213,110,6,116,1352,1468,2,15768,1918,19154,335650
2079,6,2,ITA,13,Abruzzo,42.35122196,13.39843823,113,6,119,624,743,4,2093,413,3249,53279
2080,6,2,ITA,17,Basilicata,40.63947052,15.80514834,4,0,4,20,24,0,348,27,399,29664
2081,6,2,ITA,18,Calabria,38.90597598,16.59440194,20,1,21,91,112,0,949,97,1158,69419
2082,6,2,ITA,15,Campania,40.83956555,14.25084984,236,7,243,647,890,3,3504,415,4809,100269
2083,6,2,ITA,8,Emilia-Romagna,44.49436681,11.3417208,358,50,408,2504,2912,19,20780,4136,27828,201267
2084,6,2,ITA,6,Friuli Venezia Giulia,45.6494354,13.76813649,40,2,42,202,244,2,2696,336,3276,80795
2085,6,2,ITA,12,Lazio,41.89277044,12.48366722,580,56,636,2211,2847,5,4155,741,7743,209892
2086,6,2,ITA,7,Liguria,44.41149315,8.9326992,175,7,182,364,546,15,7720,1468,9734,60631
2087,6,2,ITA,3,Lombardia,45.46679409,9.190347404,3021,166,3187,17068,20255,187,52807,16143,89205,451502
2088,6,2,ITA,11,Marche,43.61675973,13.5188753,60,9,69,1257,1326,4,4421,987,6734,66434
2089,6,2,ITA,14,Molise,41.55774754,14.65916051,3,2,5,128,133,0,281,22,436,14278
2090,6,2,ITA,21,P.A. Bolzano,46.49933453,11.35662422,13,3,16,104,120,0,2187,291,2598,31610
2091,6,2,ITA,22,P.A. Trento,46.06893511,11.12123097,14,2,16,267,283,0,3686,463,4432,49173
2092,6,2,ITA,1,Piemonte,45.0732745,7.680687483,849,46,895,3933,4828,57,22003,3884,30715,211174
2093,6,2,ITA,16,Puglia,41.12559576,16.86736689,134,11,145,906,1051,0,2939,508,4498,81372
2094,6,2,ITA,20,Sardegna,39.21531192,9.110616306,21,1,22,133,155,0,1071,131,1357,49736
2095,6,2,ITA,19,Sicilia,38.11569725,13.3623567,62,7,69,897,966,4,2206,275,3447,130886
2096,6,2,ITA,9,Toscana,43.76923077,11.25588885,85,25,110,901,1011,10,8053,1053,10117,182335
2097,6,2,ITA,10,Umbria,43.10675841,12.38824698,15,2,17,14,31,0,1324,76,1431,51508
2098,6,2,ITA,2,Valle d'Aosta,45.73750286,7.320149366,10,0,10,3,13,0,1031,143,1187,12027
2099,6,2,ITA,5,Veneto,45.43490485,12.33845213,103,5,108,1295,1403,8,15838,1921,19162,340051
2100,6,3,ITA,13,Abruzzo,42.35122196,13.39843823,112,3,115,621,736,3,2102,414,3252,53555
2101,6,3,ITA,17,Basilicata,40.63947052,15.80514834,4,0,4,19,23,0,349,27,399,29938
2102,6,3,ITA,18,Calabria,38.90597598,16.59440194,20,0,20,90,110,0,951,97,1158,69978
2103,6,3,ITA,15,Campania,40.83956555,14.25084984,206,4,210,659,869,12,3537,415,4821,101664
2104,6,3,ITA,8,Emilia-Romagna,44.49436681,11.3417208,342,50,392,2447,2839,14,20856,4147,27842,202506
2105,6,3,ITA,6,Friuli Venezia Giulia,45.6494354,13.76813649,39,2,41,192,233,0,2707,336,3276,81683
2106,6,3,ITA,12,Lazio,41.89277044,12.48366722,519,51,570,2248,2818,10,4188,747,7753,211669
2107,6,3,ITA,7,Liguria,44.41149315,8.9326992,169,6,175,339,514,17,7764,1473,9751,61006
2108,6,3,ITA,3,Lombardia,45.46679409,9.190347404,2995,131,3126,17098,20224,237,53046,16172,89442,458782
2109,6,3,ITA,11,Marche,43.61675973,13.5188753,57,8,65,1245,1310,1,4438,987,6735,66805
2110,6,3,ITA,14,Molise,41.55774754,14.65916051,1,2,3,124,127,0,287,22,436,14439
2111,6,3,ITA,21,P.A. Bolzano,46.49933453,11.35662422,13,3,16,104,120,0,2187,291,2598,31800
2112,6,3,ITA,22,P.A. Trento,46.06893511,11.12123097,15,2,17,205,222,1,3748,463,4433,49626
2113,6,3,ITA,1,Piemonte,45.0732745,7.680687483,841,44,885,3801,4686,19,22150,3898,30734,212012
2114,6,3,ITA,16,Puglia,41.12559576,16.86736689,131,10,141,895,1036,1,2952,511,4499,82041
2115,6,3,ITA,20,Sardegna,39.21531192,9.110616306,12,1,13,133,146,0,1080,131,1357,50057
2116,6,3,ITA,19,Sicilia,38.11569725,13.3623567,60,7,67,813,880,0,2292,275,3447,131820
2117,6,3,ITA,9,Toscana,43.76923077,11.25588885,76,25,101,872,973,4,8093,1055,10121,183229
2118,6,3,ITA,10,Umbria,43.10675841,12.38824698,15,2,17,14,31,0,1324,76,1431,51310
2119,6,3,ITA,2,Valle d'Aosta,45.73750286,7.320149366,9,0,9,4,13,0,1031,143,1187,12084
2120,6,3,ITA,5,Veneto,45.43490485,12.33845213,106,2,108,1279,1387,2,15856,1921,19164,341333
2121,6,4,ITA,13,Abruzzo,42.35122196,13.39843823,109,3,112,592,704,3,2136,415,3255,54527
2122,6,4,ITA,17,Basilicata,40.63947052,15.80514834,3,0,3,17,20,0,352,27,399,30706
2123,6,4,ITA,18,Calabria,38.90597598,16.59440194,19,0,19,83,102,0,959,97,1158,70813
2124,6,4,ITA,15,Campania,40.83956555,14.25084984,160,5,165,665,830,1,3572,420,4822,102305
2125,6,4,ITA,8,Emilia-Romagna,44.49436681,11.3417208,320,49,369,2319,2688,18,21018,4154,27860,204614
2126,6,4,ITA,6,Friuli Venezia Giulia,45.6494354,13.76813649,34,2,36,177,213,3,2730,336,3279,81854
2127,6,4,ITA,12,Lazio,41.89277044,12.48366722,488,51,539,2215,2754,11,4260,750,7764,214051
2128,6,4,ITA,7,Liguria,44.41149315,8.9326992,149,6,155,239,394,21,7899,1479,9772,61688
2129,6,4,ITA,3,Lombardia,45.46679409,9.190347404,2954,125,3079,17145,20224,84,53101,16201,89526,460658
2130,6,4,ITA,11,Marche,43.61675973,13.5188753,52,5,57,1246,1303,3,4447,988,6738,67429
2131,6,4,ITA,14,Molise,41.55774754,14.65916051,0,2,2,123,125,0,288,23,436,15261
2132,6,4,ITA,21,P.A. Bolzano,46.49933453,11.35662422,7,2,9,103,112,0,2194,292,2598,32135
2133,6,4,ITA,22,P.A. Trento,46.06893511,11.12123097,14,1,15,192,207,0,3762,464,4433,49920
2134,6,4,ITA,1,Piemonte,45.0732745,7.680687483,808,43,851,3705,4556,24,22292,3910,30758,214551
2135,6,4,ITA,16,Puglia,41.12559576,16.86736689,131,9,140,827,967,4,3022,514,4503,83870
2136,6,4,ITA,20,Sardegna,39.21531192,9.110616306,12,1,13,95,108,0,1118,131,1357,50865
2137,6,4,ITA,19,Sicilia,38.11569725,13.3623567,57,6,63,816,879,0,2292,276,3447,134035
2138,6,4,ITA,9,Toscana,43.76923077,11.25588885,65,24,89,794,883,1,8180,1059,10122,186632
2139,6,4,ITA,10,Umbria,43.10675841,12.38824698,15,2,17,14,31,0,1324,76,1431,52223
2140,6,4,ITA,2,Valle d'Aosta,45.73750286,7.320149366,9,0,9,1,10,0,1034,143,1187,12156
2141,6,4,ITA,5,Veneto,45.43490485,12.33845213,97,2,99,1220,1319,4,15915,1934,19168,344495
2142,6,5,ITA,13,Abruzzo,42.35122196,13.39843823,103,4,107,563,670,2,2172,415,3257,55295
2143,6,5,ITA,17,Basilicata,40.63947052,15.80514834,0,0,0,18,18,0,354,27,399,30705
2144,6,5,ITA,18,Calabria,38.90597598,16.59440194,18,0,18,79,97,1,965,97,1159,72124
2145,6,5,ITA,15,Campania,40.83956555,14.25084984,133,7,140,634,774,0,3623,425,4822,104169
2146,6,5,ITA,8,Emilia-Romagna,44.49436681,11.3417208,281,38,319,2193,2512,17,21198,4167,27877,207533
2147,6,5,ITA,6,Friuli Venezia Giulia,45.6494354,13.76813649,25,2,27,153,180,1,2762,338,3280,83600
2148,6,5,ITA,12,Lazio,41.89277044,12.48366722,480,51,531,2179,2710,9,4309,754,7773,216743
2149,6,5,ITA,7,Liguria,44.41149315,8.9326992,142,6,148,96,244,14,8056,1486,9786,62417
2150,6,5,ITA,3,Lombardia,45.46679409,9.190347404,2960,120,3080,16773,19853,402,53853,16222,89928,475041
2151,6,5,ITA,11,Marche,43.61675973,13.5188753,50,5,55,1238,1293,2,4458,989,6740,68197
2152,6,5,ITA,14,Molise,41.55774754,14.65916051,0,2,2,120,122,0,291,23,436,15568
2153,6,5,ITA,21,P.A. Bolzano,46.49933453,11.35662422,10,2,12,89,101,1,2206,292,2599,32665
2154,6,5,ITA,22,P.A. Trento,46.06893511,11.12123097,8,1,9,114,123,0,3846,464,4433,50312
2155,6,5,ITA,1,Piemonte,45.0732745,7.680687483,743,40,783,3586,4369,49,22511,3927,30807,217032
2156,6,5,ITA,16,Puglia,41.12559576,16.86736689,111,5,116,730,846,4,3140,521,4507,85007
2157,6,5,ITA,20,Sardegna,39.21531192,9.110616306,11,0,11,56,67,2,1161,131,1359,51853
2158,6,5,ITA,19,Sicilia,38.11569725,13.3623567,54,6,60,812,872,1,2300,276,3448,136155
2159,6,5,ITA,9,Toscana,43.76923077,11.25588885,55,23,78,779,857,7,8209,1063,10129,188882
2160,6,5,ITA,10,Umbria,43.10675841,12.38824698,12,2,14,15,29,0,1326,76,1431,52888
2161,6,5,ITA,2,Valle d'Aosta,45.73750286,7.320149366,9,0,9,1,10,0,1034,143,1187,12200
2162,6,5,ITA,5,Veneto,45.43490485,12.33845213,96,2,98,1131,1229,6,16007,1938,19174,346872
2163,6,6,ITA,13,Abruzzo,42.35122196,13.39843823,96,3,99,554,653,1,2187,418,3258,56223
2164,6,6,ITA,17,Basilicata,40.63947052,15.80514834,0,0,0,17,17,0,355,27,399,31102
2165,6,6,ITA,18,Calabria,38.90597598,16.59440194,18,0,18,73,91,0,971,97,1159,73228
2166,6,6,ITA,15,Campania,40.83956555,14.25084984,97,7,104,634,738,0,3658,426,4822,105814
2167,6,6,ITA,8,Emilia-Romagna,44.49436681,11.3417208,256,35,291,2125,2416,17,21307,4171,27894,210719
2168,6,6,ITA,6,Friuli Venezia Giulia,45.6494354,13.76813649,24,2,26,135,161,3,2784,338,3283,84978
2169,6,6,ITA,12,Lazio,41.89277044,12.48366722,477,49,526,2171,2697,28,4346,758,7801,219363
2170,6,6,ITA,7,Liguria,44.41149315,8.9326992,136,4,140,105,245,13,8062,1492,9799,63119
2171,6,6,ITA,3,Lombardia,45.46679409,9.190347404,2840,110,2950,16549,19499,142,54322,16249,90070,480566
2172,6,6,ITA,11,Marche,43.61675973,13.5188753,46,3,49,1146,1195,2,4556,991,6742,68775
2173,6,6,ITA,14,Molise,41.55774754,14.65916051,0,2,2,119,121,0,292,23,436,15809
2174,6,6,ITA,21,P.A. Bolzano,46.49933453,11.35662422,7,2,9,91,100,1,2208,292,2600,33291
2175,6,6,ITA,22,P.A. Trento,46.06893511,11.12123097,6,1,7,97,104,1,3866,464,4434,50758
2176,6,6,ITA,1,Piemonte,45.0732745,7.680687483,684,37,721,3446,4167,38,22744,3934,30845,219444
2177,6,6,ITA,16,Puglia,41.12559576,16.86736689,109,4,113,645,758,4,3231,522,4511,86405
2178,6,6,ITA,20,Sardegna,39.21531192,9.110616306,10,1,11,49,60,3,1171,131,1362,52956
2179,6,6,ITA,19,Sicilia,38.11569725,13.3623567,47,7,54,812,866,2,2308,276,3450,138343
2180,6,6,ITA,9,Toscana,43.76923077,11.25588885,49,22,71,714,785,5,8281,1068,10134,190860
2181,6,6,ITA,10,Umbria,43.10675841,12.38824698,11,2,13,15,28,0,1327,76,1431,53733
2182,6,6,ITA,2,Valle d'Aosta,45.73750286,7.320149366,7,0,7,5,12,2,1033,144,1189,12289
2183,6,6,ITA,5,Veneto,45.43490485,12.33845213,82,2,84,1080,1164,8,16069,1949,19182,351519
2184,6,7,ITA,13,Abruzzo,42.35122196,13.39843823,88,4,92,561,653,7,2194,418,3265,56702
2185,6,7,ITA,17,Basilicata,40.63947052,15.80514834,0,0,0,14,14,0,358,27,399,31357
2186,6,7,ITA,18,Calabria,38.90597598,16.59440194,18,0,18,73,91,0,971,97,1159,74080
2187,6,7,ITA,15,Campania,40.83956555,14.25084984,86,6,92,633,725,4,3675,426,4826,108785
2188,6,7,ITA,8,Emilia-Romagna,44.49436681,11.3417208,245,32,277,2051,2328,14,21405,4175,27908,213979
2189,6,7,ITA,6,Friuli Venezia Giulia,45.6494354,13.76813649,22,4,26,125,151,0,2793,339,3283,85671
2190,6,7,ITA,12,Lazio,41.89277044,12.48366722,467,49,516,2174,2690,11,4362,760,7812,221612
2191,6,7,ITA,7,Liguria,44.41149315,8.9326992,127,5,132,111,243,13,8070,1499,9812,63749
2192,6,7,ITA,3,Lombardia,45.46679409,9.190347404,2801,107,2908,16512,19420,125,54505,16270,90195,485842
2193,6,7,ITA,11,Marche,43.61675973,13.5188753,41,2,43,1116,1159,3,4595,991,6745,69376
2194,6,7,ITA,14,Molise,41.55774754,14.65916051,0,2,2,118,120,0,293,23,436,16056
2195,6,7,ITA,21,P.A. Bolzano,46.49933453,11.35662422,7,2,9,88,97,3,2214,292,2603,33944
2196,6,7,ITA,22,P.A. Trento,46.06893511,11.12123097,6,1,7,75,82,1,3889,464,4435,51385
2197,6,7,ITA,1,Piemonte,45.0732745,7.680687483,659,38,697,3265,3962,10,22952,3941,30855,221367
2198,6,7,ITA,16,Puglia,41.12559576,16.86736689,96,4,100,633,733,0,3253,525,4511,86405
2199,6,7,ITA,20,Sardegna,39.21531192,9.110616306,10,1,11,48,59,0,1172,131,1362,53735
2200,6,7,ITA,19,Sicilia,38.11569725,13.3623567,42,7,49,813,862,1,2312,277,3451,139481
2201,6,7,ITA,9,Toscana,43.76923077,11.25588885,52,20,72,678,750,1,8315,1070,10135,192675
2202,6,7,ITA,10,Umbria,43.10675841,12.38824698,10,2,12,17,29,1,1327,76,1432,54314
2203,6,7,ITA,2,Valle d'Aosta,45.73750286,7.320149366,6,0,6,3,9,2,1038,144,1191,12335
2204,6,7,ITA,5,Veneto,45.43490485,12.33845213,81,1,82,1003,1085,1,16144,1954,19183,354338
2205,6,8,ITA,13,Abruzzo,42.35122196,13.39843823,89,4,93,539,632,0,2215,418,3265,57165
2206,6,8,ITA,17,Basilicata,40.63947052,15.80514834,0,0,0,13,13,0,359,27,399,31930
2207,6,8,ITA,18,Calabria,38.90597598,16.59440194,18,0,18,59,77,0,985,97,1159,74439
2208,6,8,ITA,15,Campania,40.83956555,14.25084984,82,6,88,629,717,2,3685,426,4828,109534
2209,6,8,ITA,8,Emilia-Romagna,44.49436681,11.3417208,239,31,270,2012,2282,20,21467,4179,27928,215416
2210,6,8,ITA,6,Friuli Venezia Giulia,45.6494354,13.76813649,22,3,25,119,144,1,2800,340,3284,85834
2211,6,8,ITA,12,Lazio,41.89277044,12.48366722,466,49,515,2100,2615,16,4450,763,7828,222963
2212,6,8,ITA,7,Liguria,44.41149315,8.9326992,125,5,130,118,248,14,8073,1505,9826,64349
2213,6,8,ITA,3,Lombardia,45.46679409,9.190347404,2708,107,2815,16504,19319,194,54768,16302,90389,489775
2214,6,8,ITA,11,Marche,43.61675973,13.5188753,41,2,43,1032,1075,2,4681,991,6747,69736
2215,6,8,ITA,14,Molise,41.55774754,14.65916051,0,2,2,117,119,0,294,23,436,16224
2216,6,8,ITA,21,P.A. Bolzano,46.49933453,11.35662422,7,2,9,88,97,1,2215,292,2604,34307
2217,6,8,ITA,22,P.A. Trento,46.06893511,11.12123097,7,1,8,73,81,1,3891,464,4436,51453
2218,6,8,ITA,1,Piemonte,45.0732745,7.680687483,633,36,669,3197,3866,14,23049,3954,30869,222000
2219,6,8,ITA,16,Puglia,41.12559576,16.86736689,94,4,98,600,698,1,3289,525,4512,88228
2220,6,8,ITA,20,Sardegna,39.21531192,9.110616306,9,1,10,46,56,0,1175,131,1362,54051
2221,6,8,ITA,19,Sicilia,38.11569725,13.3623567,40,7,47,806,853,1,2321,278,3452,140109
2222,6,8,ITA,9,Toscana,43.76923077,11.25588885,50,20,70,651,721,9,8349,1074,10144,193737
2223,6,8,ITA,10,Umbria,43.10675841,12.38824698,10,2,12,17,29,0,1327,76,1432,54486
2224,6,8,ITA,2,Valle d'Aosta,45.73750286,7.320149366,7,0,7,1,8,0,1039,144,1191,12385
2225,6,8,ITA,5,Veneto,45.43490485,12.33845213,82,1,83,997,1080,4,16152,1955,19187,355368
2226,6,9,ITA,13,Abruzzo,42.35122196,13.39843823,91,4,95,472,567,1,2248,451,3266,57880
2227,6,9,ITA,17,Basilicata,40.63947052,15.80514834,1,0,1,13,14,1,359,27,400,32395
2228,6,9,ITA,18,Calabria,38.90597598,16.59440194,18,0,18,50,68,0,994,97,1159,75154
2229,6,9,ITA,15,Campania,40.83956555,14.25084984,73,3,76,599,675,5,3732,426,4833,110583
2230,6,9,ITA,8,Emilia-Romagna,44.49436681,11.3417208,226,31,257,1899,2156,18,21605,4185,27946,218890
2231,6,9,ITA,6,Friuli Venezia Giulia,45.6494354,13.76813649,21,2,23,105,128,0,2816,340,3284,86257
2232,6,9,ITA,12,Lazio,41.89277044,12.48366722,462,47,509,2061,2570,23,4515,766,7851,225930
2233,6,9,ITA,7,Liguria,44.41149315,8.9326992,119,5,124,125,249,8,8076,1509,9834,65073
2234,6,9,ITA,3,Lombardia,45.46679409,9.190347404,2660,96,2756,15541,18297,192,55967,16317,90581,496273
2235,6,9,ITA,11,Marche,43.61675973,13.5188753,32,0,32,960,992,0,4763,992,6747,70335
2236,6,9,ITA,14,Molise,41.55774754,14.65916051,0,2,2,118,120,2,295,23,438,16411
2237,6,9,ITA,21,P.A. Bolzano,46.49933453,11.35662422,7,2,9,86,95,0,2217,292,2604,34607
2238,6,9,ITA,22,P.A. Trento,46.06893511,11.12123097,6,1,7,74,81,3,3894,464,4439,51934
2239,6,9,ITA,1,Piemonte,45.0732745,7.680687483,599,39,638,3033,3671,21,23258,3961,30890,224293
2240,6,9,ITA,16,Puglia,41.12559576,16.86736689,76,5,81,532,613,0,3373,526,4512,90248
2241,6,9,ITA,20,Sardegna,39.21531192,9.110616306,9,1,10,44,54,-1,1176,131,1361,54707
2242,6,9,ITA,19,Sicilia,38.11569725,13.3623567,39,6,45,808,853,2,2323,278,3454,142495
2243,6,9,ITA,9,Toscana,43.76923077,11.25588885,46,17,63,565,628,1,8440,1077,10145,195695
2244,6,9,ITA,10,Umbria,43.10675841,12.38824698,12,2,14,15,29,3,1330,76,1435,55145
2245,6,9,ITA,2,Valle d'Aosta,45.73750286,7.320149366,7,0,7,1,8,0,1039,144,1191,12436
2246,6,9,ITA,5,Veneto,45.43490485,12.33845213,77,0,77,927,1004,4,16226,1961,19191,358948
2247,6,10,ITA,13,Abruzzo,42.35122196,13.39843823,83,5,88,462,550,0,2263,453,3266,58766
2248,6,10,ITA,17,Basilicata,40.63947052,15.80514834,1,0,1,10,11,0,362,27,400,32761
2249,6,10,ITA,18,Calabria,38.90597598,16.59440194,18,0,18,36,54,0,1008,97,1159,76112
2250,6,10,ITA,15,Campania,40.83956555,14.25084984,74,2,76,566,642,1,3764,428,4834,112309
2251,6,10,ITA,8,Emilia-Romagna,44.49436681,11.3417208,228,25,253,1808,2061,24,21717,4192,27970,223413
2252,6,10,ITA,6,Friuli Venezia Giulia,45.6494354,13.76813649,25,1,26,87,113,2,2832,341,3286,90061
2253,6,10,ITA,12,Lazio,41.89277044,12.48366722,368,47,415,2151,2566,18,4533,770,7869,229513
2254,6,10,ITA,7,Liguria,44.41149315,8.9326992,110,3,113,132,245,20,8096,1513,9854,66009
2255,6,10,ITA,3,Lombardia,45.46679409,9.190347404,2565,98,2663,15194,17857,99,56474,16349,90680,502047
2256,6,10,ITA,11,Marche,43.61675973,13.5188753,29,0,29,918,947,3,4811,992,6750,70837
2257,6,10,ITA,14,Molise,41.55774754,14.65916051,0,2,2,118,120,1,296,23,439,16611
2258,6,10,ITA,21,P.A. Bolzano,46.49933453,11.35662422,7,2,9,85,94,0,2218,292,2604,35148
2259,6,10,ITA,22,P.A. Trento,46.06893511,11.12123097,6,1,7,73,80,0,3895,464,4439,52412
2260,6,10,ITA,1,Piemonte,45.0732745,7.680687483,564,35,599,2773,3372,26,23568,3976,30916,226874
2261,6,10,ITA,16,Puglia,41.12559576,16.86736689,71,4,75,482,557,0,3426,529,4512,91918
2262,6,10,ITA,20,Sardegna,39.21531192,9.110616306,9,1,10,40,50,0,1180,131,1361,55439
2263,6,10,ITA,19,Sicilia,38.11569725,13.3623567,40,6,46,807,853,1,2324,278,3455,144193
2264,6,10,ITA,9,Toscana,43.76923077,11.25588885,40,15,55,484,539,3,8531,1078,10148,198466
2265,6,10,ITA,10,Umbria,43.10675841,12.38824698,13,2,15,13,28,1,1332,76,1436,55763
2266,6,10,ITA,2,Valle d'Aosta,45.73750286,7.320149366,3,0,3,3,6,0,1041,144,1191,12502
2267,6,10,ITA,5,Veneto,45.43490485,12.33845213,66,0,66,899,965,3,16268,1961,19194,362400
2268,6,11,ITA,13,Abruzzo,42.35122196,13.39843823,81,5,86,453,539,1,2275,453,3267,59505
2269,6,11,ITA,17,Basilicata,40.63947052,15.80514834,0,1,1,11,12,1,362,27,401,33167
2270,6,11,ITA,18,Calabria,38.90597598,16.59440194,16,1,17,35,52,2,1012,97,1161,76963
2271,6,11,ITA,15,Campania,40.83956555,14.25084984,74,2,76,534,610,3,3797,430,4837,114073
2272,6,11,ITA,8,Emilia-Romagna,44.49436681,11.3417208,216,18,234,1766,2000,25,21803,4192,27995,227500
2273,6,11,ITA,6,Friuli Venezia Giulia,45.6494354,13.76813649,22,0,22,90,112,1,2833,342,3287,90508
2274,6,11,ITA,12,Lazio,41.89277044,12.48366722,320,46,366,2151,2517,20,4596,776,7889,233158
2275,6,11,ITA,7,Liguria,44.41149315,8.9326992,107,3,110,140,250,10,8100,1514,9864,66755
2276,6,11,ITA,3,Lombardia,45.46679409,9.190347404,2488,97,2585,14755,17340,252,57218,16374,90932,509853
2277,6,11,ITA,11,Marche,43.61675973,13.5188753,26,0,26,876,902,1,4857,992,6751,71531
2278,6,11,ITA,14,Molise,41.55774754,14.65916051,1,1,2,114,116,0,300,23,439,16916
2279,6,11,ITA,21,P.A. Bolzano,46.49933453,11.35662422,8,2,10,89,99,2,2215,292,2606,35553
2280,6,11,ITA,22,P.A. Trento,46.06893511,11.12123097,5,1,6,65,71,2,3906,464,4441,52795
2281,6,11,ITA,1,Piemonte,45.0732745,7.680687483,544,33,577,2606,3183,42,23787,3988,30958,229096
2282,6,11,ITA,16,Puglia,41.12559576,16.86736689,65,3,68,399,467,1,3516,530,4513,93130
2283,6,11,ITA,20,Sardegna,39.21531192,9.110616306,10,1,11,32,43,1,1188,131,1362,56226
2284,6,11,ITA,19,Sicilia,38.11569725,13.3623567,37,5,42,807,849,0,2327,279,3455,146290
2285,6,11,ITA,9,Toscana,43.76923077,11.25588885,42,15,57,464,521,10,8558,1079,10158,200500
2286,6,11,ITA,10,Umbria,43.10675841,12.38824698,11,2,13,13,26,0,1334,76,1436,56310
2287,6,11,ITA,2,Valle d'Aosta,45.73750286,7.320149366,6,0,6,0,6,0,1041,144,1191,12606
2288,6,11,ITA,5,Veneto,45.43490485,12.33845213,52,0,52,870,922,5,16313,1964,19199,364110
2289,6,12,ITA,13,Abruzzo,42.35122196,13.39843823,76,4,80,448,528,4,2290,453,3271,60229
2290,6,12,ITA,17,Basilicata,40.63947052,15.80514834,0,1,1,11,12,0,362,27,401,33587
2291,6,12,ITA,18,Calabria,38.90597598,16.59440194,16,1,17,30,47,0,1017,97,1161,78001
2292,6,12,ITA,15,Campania,40.83956555,14.25084984,61,2,63,283,346,-229,3832,430,4608,115842
2293,6,12,ITA,8,Emilia-Romagna,44.49436681,11.3417208,200,17,217,1600,1817,33,22015,4196,28028,231752
2294,6,12,ITA,6,Friuli Venezia Giulia,45.6494354,13.76813649,18,0,18,90,108,3,2840,342,3290,92278
2295,6,12,ITA,12,Lazio,41.89277044,12.48366722,293,47,340,1882,2222,27,4913,781,7916,237100
2296,6,12,ITA,7,Liguria,44.41149315,8.9326992,103,3,106,143,249,7,8106,1516,9871,67544
2297,6,12,ITA,3,Lombardia,45.46679409,9.190347404,2357,97,2454,14570,17024,272,57775,16405,91204,519095
2298,6,12,ITA,11,Marche,43.61675973,13.5188753,22,0,22,728,750,1,5009,993,6752,72169
2299,6,12,ITA,14,Molise,41.55774754,14.65916051,1,1,2,112,114,0,302,23,439,17279
2300,6,12,ITA,21,P.A. Bolzano,46.49933453,11.35662422,8,2,10,91,101,2,2216,291,2608,35974
2301,6,12,ITA,22,P.A. Trento,46.06893511,11.12123097,5,1,6,62,68,2,3911,464,4443,53453
2302,6,12,ITA,1,Piemonte,45.0732745,7.680687483,527,30,557,2340,2897,31,24096,3996,30989,230888
2303,6,12,ITA,16,Puglia,41.12559576,16.86736689,61,2,63,376,439,2,3544,532,4515,94456
2304,6,12,ITA,20,Sardegna,39.21531192,9.110616306,10,1,11,31,42,1,1190,131,1363,56937
2305,6,12,ITA,19,Sicilia,38.11569725,13.3623567,34,3,37,804,841,0,2335,279,3455,147871
2306,6,12,ITA,9,Toscana,43.76923077,11.25588885,36,14,50,460,510,7,8575,1080,10165,202577
2307,6,12,ITA,10,Umbria,43.10675841,12.38824698,10,1,11,13,24,0,1336,76,1436,56914
2308,6,12,ITA,2,Valle d'Aosta,45.73750286,7.320149366,6,0,6,3,9,0,1038,144,1191,12671
2309,6,12,ITA,5,Veneto,45.43490485,12.33845213,49,0,49,800,849,0,16383,1967,19199,367579
2310,6,13,ITA,13,Abruzzo,42.35122196,13.39843823,72,4,76,433,509,4,2312,454,3275,61177
2311,6,13,ITA,17,Basilicata,40.63947052,15.80514834,0,1,1,10,11,0,363,27,401,33891
2312,6,13,ITA,18,Calabria,38.90597598,16.59440194,15,1,16,29,45,1,1020,97,1162,79193
2313,6,13,ITA,15,Campania,40.83956555,14.25084984,67,2,69,268,337,0,3841,430,4608,118820
2314,6,13,ITA,8,Emilia-Romagna,44.49436681,11.3417208,192,15,207,1520,1727,28,22130,4199,28056,237236
2315,6,13,ITA,6,Friuli Venezia Giulia,45.6494354,13.76813649,15,0,15,90,105,6,2848,343,3296,93222
2316,6,13,ITA,12,Lazio,41.89277044,12.48366722,303,45,348,1009,1357,25,5778,806,7941,239788
2317,6,13,ITA,7,Liguria,44.41149315,8.9326992,91,3,94,150,244,4,8113,1518,9875,68333
2318,6,13,ITA,3,Lombardia,45.46679409,9.190347404,2252,96,2348,14437,16785,210,58201,16428,91414,524774
2319,6,13,ITA,11,Marche,43.61675973,13.5188753,22,0,22,655,677,2,5084,993,6754,72713
2320,6,13,ITA,14,Molise,41.55774754,14.65916051,0,0,0,97,97,0,319,23,439,17630
2321,6,13,ITA,21,P.A. Bolzano,46.49933453,11.35662422,7,2,9,86,95,2,2224,291,2610,36393
2322,6,13,ITA,22,P.A. Trento,46.06893511,11.12123097,5,1,6,64,70,3,3912,464,4446,54175
2323,6,13,ITA,1,Piemonte,45.0732745,7.680687483,510,27,537,2283,2820,40,24203,4006,31029,232980
2324,6,13,ITA,16,Puglia,41.12559576,16.86736689,60,2,62,360,422,0,3561,532,4515,96053
2325,6,13,ITA,20,Sardegna,39.21531192,9.110616306,12,0,12,22,34,0,1197,132,1363,57763
2326,6,13,ITA,19,Sicilia,38.11569725,13.3623567,33,3,36,806,842,1,2335,279,3456,149516
2327,6,13,ITA,9,Toscana,43.76923077,11.25588885,33,16,49,453,502,7,8588,1082,10172,204513
2328,6,13,ITA,10,Umbria,43.10675841,12.38824698,10,1,11,10,21,0,1339,76,1436,57511
2329,6,13,ITA,2,Valle d'Aosta,45.73750286,7.320149366,7,0,7,0,7,0,1040,144,1191,12736
2330,6,13,ITA,5,Veneto,45.43490485,12.33845213,41,1,42,736,778,13,16457,1977,19212,368659
2331,6,14,ITA,13,Abruzzo,42.35122196,13.39843823,71,4,75,436,511,4,2312,456,3279,61873
2332,6,14,ITA,17,Basilicata,40.63947052,15.80514834,0,1,1,10,11,0,363,27,401,34349
2333,6,14,ITA,18,Calabria,38.90597598,16.59440194,15,1,16,28,44,0,1021,97,1162,79919
2334,6,14,ITA,15,Campania,40.83956555,14.25084984,53,2,55,264,319,1,3860,430,4609,121618
2335,6,14,ITA,8,Emilia-Romagna,44.49436681,11.3417208,192,14,206,1431,1637,17,22232,4204,28073,241833
2336,6,14,ITA,6,Friuli Venezia Giulia,45.6494354,13.76813649,15,1,16,87,103,0,2850,343,3296,93641
2337,6,14,ITA,12,Lazio,41.89277044,12.48366722,305,37,342,980,1322,14,5825,808,7955,242245
2338,6,14,ITA,7,Liguria,44.41149315,8.9326992,85,3,88,155,243,4,8115,1521,9879,68766
2339,6,14,ITA,3,Lombardia,45.46679409,9.190347404,2116,94,2210,13779,15989,244,59220,16449,91658,530683
2340,6,14,ITA,11,Marche,43.61675973,13.5188753,21,0,21,605,626,4,5139,993,6758,73298
2341,6,14,ITA,14,Molise,41.55774754,14.65916051,0,0,0,74,74,0,342,23,439,17947
2342,6,14,ITA,21,P.A. Bolzano,46.49933453,11.35662422,8,2,10,85,95,3,2227,291,2613,36607
2343,6,14,ITA,22,P.A. Trento,46.06893511,11.12123097,5,1,6,60,66,1,3917,464,4447,55054
2344,6,14,ITA,1,Piemonte,45.0732745,7.680687483,517,26,543,2105,2648,30,24399,4012,31059,234561
2345,6,14,ITA,16,Puglia,41.12559576,16.86736689,57,2,59,359,418,0,3565,532,4515,96820
2346,6,14,ITA,20,Sardegna,39.21531192,9.110616306,12,0,12,21,33,0,1198,132,1363,58281
2347,6,14,ITA,19,Sicilia,38.11569725,13.3623567,32,3,35,802,837,1,2341,279,3457,150233
2348,6,14,ITA,9,Toscana,43.76923077,11.25588885,34,16,50,449,499,8,8596,1085,10180,206348
2349,6,14,ITA,10,Umbria,43.10675841,12.38824698,9,1,10,10,20,0,1339,77,1436,58013
2350,6,14,ITA,2,Valle d'Aosta,45.73750286,7.320149366,7,0,7,0,7,0,1040,144,1191,12806
2351,6,14,ITA,5,Veneto,45.43490485,12.33845213,40,1,41,731,772,7,16469,1978,19219,371726
2352,6,15,ITA,13,Abruzzo,42.35122196,13.39843823,71,3,74,412,486,0,2337,456,3279,62048
2353,6,15,ITA,17,Basilicata,40.63947052,15.80514834,0,1,1,10,11,0,363,27,401,34443
2354,6,15,ITA,18,Calabria,38.90597598,16.59440194,17,1,18,19,37,0,1028,97,1162,80330
2355,6,15,ITA,15,Campania,40.83956555,14.25084984,58,2,60,229,289,4,3894,430,4613,122291
2356,6,15,ITA,8,Emilia-Romagna,44.49436681,11.3417208,188,13,201,1299,1500,11,22377,4207,28084,244630
2357,6,15,ITA,6,Friuli Venezia Giulia,45.6494354,13.76813649,15,1,16,83,99,0,2854,343,3296,94567
2358,6,15,ITA,12,Lazio,41.89277044,12.48366722,304,37,341,951,1292,3,5855,811,7958,243805
2359,6,15,ITA,7,Liguria,44.41149315,8.9326992,87,2,89,157,246,8,8116,1525,9887,69345
2360,6,15,ITA,3,Lombardia,45.46679409,9.190347404,2018,94,2112,13864,15976,259,59484,16457,91917,534981
2361,6,15,ITA,11,Marche,43.61675973,13.5188753,18,0,18,599,617,4,5152,993,6762,73564
2362,6,15,ITA,14,Molise,41.55774754,14.65916051,0,0,0,70,70,0,346,23,439,18214
2363,6,15,ITA,21,P.A. Bolzano,46.49933453,11.35662422,8,1,9,85,94,0,2225,292,2611,36698
2364,6,15,ITA,22,P.A. Trento,46.06893511,11.12123097,5,0,5,61,66,1,3917,465,4448,55322
2365,6,15,ITA,1,Piemonte,45.0732745,7.680687483,517,28,545,2059,2604,2,24445,4012,31061,234980
2366,6,15,ITA,16,Puglia,41.12559576,16.86736689,56,2,58,352,410,1,3572,534,4516,97877
2367,6,15,ITA,20,Sardegna,39.21531192,9.110616306,12,0,12,21,33,0,1198,132,1363,58586
2368,6,15,ITA,19,Sicilia,38.11569725,13.3623567,30,4,34,771,805,1,2373,280,3458,150982
2369,6,15,ITA,9,Toscana,43.76923077,11.25588885,31,16,47,442,489,8,8611,1088,10188,207371
2370,6,15,ITA,10,Umbria,43.10675841,12.38824698,9,1,10,8,18,0,1341,77,1436,58164
2371,6,15,ITA,2,Valle d'Aosta,45.73750286,7.320149366,7,0,7,5,12,0,1035,144,1191,12829
2372,6,15,ITA,5,Veneto,45.43490485,12.33845213,38,1,39,716,755,1,16487,1978,19220,373057
2373,6,16,ITA,13,Abruzzo,42.35122196,13.39843823,67,3,70,398,468,1,2355,457,3280,62709
2374,6,16,ITA,17,Basilicata,40.63947052,15.80514834,0,1,1,9,10,0,364,27,401,34876
2375,6,16,ITA,18,Calabria,38.90597598,16.59440194,18,0,18,18,36,0,1029,97,1162,81219
2376,6,16,ITA,15,Campania,40.83956555,14.25084984,57,2,59,214,273,0,3910,430,4613,123167
2377,6,16,ITA,8,Emilia-Romagna,44.49436681,11.3417208,180,11,191,1214,1405,13,22483,4209,28097,247911
2378,6,16,ITA,6,Friuli Venezia Giulia,45.6494354,13.76813649,14,0,14,85,99,1,2855,343,3297,95057
2379,6,16,ITA,12,Lazio,41.89277044,12.48366722,308,38,346,783,1129,9,6024,814,7967,245960
2380,6,16,ITA,7,Liguria,44.41149315,8.9326992,76,2,78,164,242,4,8120,1529,9891,69980
2381,6,16,ITA,3,Lombardia,45.46679409,9.190347404,1902,69,1971,13262,15233,143,60361,16466,92060,539604
2382,6,16,ITA,11,Marche,43.61675973,13.5188753,19,0,19,582,601,1,5168,994,6763,74194
2383,6,16,ITA,14,Molise,41.55774754,14.65916051,1,0,1,64,65,0,351,23,439,18444
2384,6,16,ITA,21,P.A. Bolzano,46.49933453,11.35662422,8,1,9,84,93,0,2226,292,2611,36931
2385,6,16,ITA,22,P.A. Trento,46.06893511,11.12123097,2,0,2,62,64,0,3919,465,4448,55530
2386,6,16,ITA,1,Piemonte,45.0732745,7.680687483,472,28,500,1950,2450,29,24622,4018,31090,236721
2387,6,16,ITA,16,Puglia,41.12559576,16.86736689,48,2,50,303,353,0,3628,535,4516,99985
2388,6,16,ITA,20,Sardegna,39.21531192,9.110616306,13,0,13,20,33,2,1200,132,1365,59536
2389,6,16,ITA,19,Sicilia,38.11569725,13.3623567,32,4,36,770,806,2,2374,280,3460,152670
2390,6,16,ITA,9,Toscana,43.76923077,11.25588885,34,14,48,415,463,3,8637,1091,10191,209629
2391,6,16,ITA,10,Umbria,43.10675841,12.38824698,8,1,9,9,18,1,1342,77,1437,58815
2392,6,16,ITA,2,Valle d'Aosta,45.73750286,7.320149366,6,0,6,4,10,0,1037,144,1191,12907
2393,6,16,ITA,5,Veneto,45.43490485,12.33845213,36,1,37,681,718,1,16521,1982,19221,376001
2394,6,17,ITA,13,Abruzzo,42.35122196,13.39843823,61,2,63,375,438,2,2386,457,3281,63630
2395,6,17,ITA,17,Basilicata,40.63947052,15.80514834,0,1,1,9,10,0,364,27,401,35221
2396,6,17,ITA,18,Calabria,38.90597598,16.59440194,18,0,18,15,33,0,1032,97,1162,82203
2397,6,17,ITA,15,Campania,40.83956555,14.25084984,48,2,50,208,258,1,3925,431,4614,124041
2398,6,17,ITA,8,Emilia-Romagna,44.49436681,11.3417208,173,11,184,1161,1345,14,22551,4215,28111,252139
2399,6,17,ITA,6,Friuli Venezia Giulia,45.6494354,13.76813649,16,0,16,83,99,2,2857,343,3299,96534
2400,6,17,ITA,12,Lazio,41.89277044,12.48366722,284,38,322,717,1039,10,6120,818,7977,248746
2401,6,17,ITA,7,Liguria,44.41149315,8.9326992,73,2,75,169,244,5,8120,1532,9896,70737
2402,6,17,ITA,3,Lombardia,45.46679409,9.190347404,1796,59,1855,13117,14972,242,60850,16480,92302,547133
2403,6,17,ITA,11,Marche,43.61675973,13.5188753,21,0,21,564,585,1,5185,994,6764,74827
2404,6,17,ITA,14,Molise,41.55774754,14.65916051,1,0,1,61,62,1,355,23,440,18684
2405,6,17,ITA,21,P.A. Bolzano,46.49933453,11.35662422,8,1,9,78,87,0,2232,292,2611,37210
2406,6,17,ITA,22,P.A. Trento,46.06893511,11.12123097,2,0,2,56,58,1,3926,465,4449,56032
2407,6,17,ITA,1,Piemonte,45.0732745,7.680687483,448,25,473,1912,2385,41,24720,4026,31131,238650
2408,6,17,ITA,16,Puglia,41.12559576,16.86736689,46,2,48,276,324,0,3656,536,4516,101350
2409,6,17,ITA,20,Sardegna,39.21531192,9.110616306,11,0,11,20,31,1,1203,132,1366,60606
2410,6,17,ITA,19,Sicilia,38.11569725,13.3623567,25,3,28,777,805,2,2377,280,3462,154287
2411,6,17,ITA,9,Toscana,43.76923077,11.25588885,33,14,47,397,444,2,8657,1092,10193,212090
2412,6,17,ITA,10,Umbria,43.10675841,12.38824698,7,2,9,9,18,0,1342,77,1437,59407
2413,6,17,ITA,2,Valle d'Aosta,45.73750286,7.320149366,5,0,5,3,8,0,1039,144,1191,12996
2414,6,17,ITA,5,Veneto,45.43490485,12.33845213,37,1,38,642,680,4,16558,1987,19225,379280
2415,6,18,ITA,13,Abruzzo,42.35122196,13.39843823,58,2,60,374,434,2,2389,458,3281,64327
2416,6,18,ITA,17,Basilicata,40.63947052,15.80514834,0,1,1,9,10,0,364,27,401,35592
2417,6,18,ITA,18,Calabria,38.90597598,16.59440194,18,0,18,17,35,3,1033,97,1165,83171
2418,6,18,ITA,15,Campania,40.83956555,14.25084984,52,6,58,184,242,1,3942,431,4615,124683
2419,6,18,ITA,8,Emilia-Romagna,44.49436681,11.3417208,159,11,170,1111,1281,32,22643,4219,28143,256490
2420,6,18,ITA,6,Friuli Venezia Giulia,45.6494354,13.76813649,15,1,16,81,97,2,2861,343,3301,97662
2421,6,18,ITA,12,Lazio,41.89277044,12.48366722,261,38,299,698,997,9,6167,822,7986,251673
2422,6,18,ITA,7,Liguria,44.41149315,8.9326992,70,2,72,174,246,7,8121,1536,9903,71497
2423,6,18,ITA,3,Lombardia,45.46679409,9.190347404,1673,60,1733,12914,14647,216,61355,16516,92518,554148
2424,6,18,ITA,11,Marche,43.61675973,13.5188753,19,0,19,558,577,4,5197,994,6768,75604
2425,6,18,ITA,14,Molise,41.55774754,14.65916051,1,0,1,59,60,0,357,23,440,19006
2426,6,18,ITA,21,P.A. Bolzano,46.49933453,11.35662422,8,2,10,75,85,2,2236,292,2613,37563
2427,6,18,ITA,22,P.A. Trento,46.06893511,11.12123097,2,0,2,57,59,8,3933,465,4457,56609
2428,6,18,ITA,1,Piemonte,45.0732745,7.680687483,397,25,422,1868,2290,31,24840,4032,31162,241279
2429,6,18,ITA,16,Puglia,41.12559576,16.86736689,34,1,35,271,306,3,3675,538,4519,103148
2430,6,18,ITA,20,Sardegna,39.21531192,9.110616306,10,0,10,21,31,1,1204,132,1367,61674
2431,6,18,ITA,19,Sicilia,38.11569725,13.3623567,24,3,27,610,637,2,2547,280,3464,155903
2432,6,18,ITA,9,Toscana,43.76923077,11.25588885,23,13,36,402,438,2,8664,1093,10195,213644
2433,6,18,ITA,10,Umbria,43.10675841,12.38824698,5,2,7,9,16,0,1344,77,1437,59912
2434,6,18,ITA,2,Valle d'Aosta,45.73750286,7.320149366,5,0,5,1,6,0,1040,145,1191,13097
2435,6,18,ITA,5,Veneto,45.43490485,12.33845213,33,1,34,573,607,8,16632,1994,19233,382042
2436,6,19,ITA,13,Abruzzo,42.35122196,13.39843823,53,1,54,353,407,1,2414,459,3280,64987
2437,6,19,ITA,17,Basilicata,40.63947052,15.80514834,0,1,1,7,8,0,366,27,401,35915
2438,6,19,ITA,18,Calabria,38.90597598,16.59440194,18,0,18,16,34,0,1034,97,1165,84222
2439,6,19,ITA,15,Campania,40.83956555,14.25084984,47,3,50,75,125,0,4059,431,4615,125525
2440,6,19,ITA,8,Emilia-Romagna,44.49436681,11.3417208,145,11,156,1063,1219,27,22727,4224,28170,261017
2441,6,19,ITA,6,Friuli Venezia Giulia,45.6494354,13.76813649,16,0,16,69,85,2,2875,343,3303,98912
2442,6,19,ITA,12,Lazio,41.89277044,12.48366722,247,38,285,703,988,9,6181,826,7995,254525
2443,6,19,ITA,7,Liguria,44.41149315,8.9326992,66,3,69,180,249,7,8121,1540,9910,72175
2444,6,19,ITA,3,Lombardia,45.46679409,9.190347404,1537,60,1597,12448,14045,157,62096,16534,92675,560376
2445,6,19,ITA,11,Marche,43.61675973,13.5188753,14,0,14,546,560,0,5214,994,6768,76228
2446,6,19,ITA,14,Molise,41.55774754,14.65916051,2,0,2,51,53,1,365,23,441,19208
2447,6,19,ITA,21,P.A. Bolzano,46.49933453,11.35662422,3,1,4,71,75,2,2248,292,2615,37858
2448,6,19,ITA,22,P.A. Trento,46.06893511,11.12123097,2,0,2,54,56,1,3936,466,4458,57050
2449,6,19,ITA,1,Piemonte,45.0732745,7.680687483,363,22,385,1793,2178,26,24971,4039,31188,243025
2450,6,19,ITA,16,Puglia,41.12559576,16.86736689,31,1,32,223,255,1,3727,538,4520,104225
2451,6,19,ITA,20,Sardegna,39.21531192,9.110616306,10,0,10,20,30,1,1206,132,1368,62546
2452,6,19,ITA,19,Sicilia,38.11569725,13.3623567,21,5,26,124,150,3,2640,280,3070,156719
2453,6,19,ITA,9,Toscana,43.76923077,11.25588885,18,12,30,393,423,10,8687,1095,10205,214853
2454,6,19,ITA,10,Umbria,43.10675841,12.38824698,5,2,7,10,17,1,1344,77,1438,60357
2455,6,19,ITA,2,Valle d'Aosta,45.73750286,7.320149366,4,0,4,0,4,0,1041,146,1191,13182
2456,6,19,ITA,5,Veneto,45.43490485,12.33845213,30,1,31,551,582,2,16655,1998,19235,384389
2457,6,20,ITA,13,Abruzzo,42.35122196,13.39843823,49,3,52,352,404,1,2418,459,3281,65606
2458,6,20,ITA,17,Basilicata,40.63947052,15.80514834,0,1,1,7,8,0,366,27,401,36185
2459,6,20,ITA,18,Calabria,38.90597598,16.59440194,18,0,18,12,30,3,1040,97,1167,85241
2460,6,20,ITA,15,Campania,40.83956555,14.25084984,48,1,49,76,125,0,4059,431,4615,126398
2461,6,20,ITA,8,Emilia-Romagna,44.49436681,11.3417208,140,11,151,1056,1207,28,22761,4230,28198,266062
2462,6,20,ITA,6,Friuli Venezia Giulia,45.6494354,13.76813649,16,1,17,66,83,1,2877,344,3304,99462
2463,6,20,ITA,12,Lazio,41.89277044,12.48366722,247,39,286,701,987,14,6195,827,8009,257265
2464,6,20,ITA,7,Liguria,44.41149315,8.9326992,61,3,64,186,250,10,8125,1545,9920,73012
2465,6,20,ITA,3,Lombardia,45.46679409,9.190347404,1401,54,1455,12456,13911,165,62372,16557,92840,565933
2466,6,20,ITA,11,Marche,43.61675973,13.5188753,13,0,13,526,539,0,5235,994,6768,76777
2467,6,20,ITA,14,Molise,41.55774754,14.65916051,2,0,2,51,53,0,365,23,441,19445
2468,6,20,ITA,21,P.A. Bolzano,46.49933453,11.35662422,3,1,4,72,76,0,2250,292,2618,38276
2469,6,20,ITA,22,P.A. Trento,46.06893511,11.12123097,1,0,1,50,51,0,3941,466,4458,57678
2470,6,20,ITA,1,Piemonte,45.0732745,7.680687483,358,17,375,1713,2088,27,25082,4045,31215,244951
2471,6,20,ITA,16,Puglia,41.12559576,16.86736689,32,1,33,187,220,5,3765,540,4525,105780
2472,6,20,ITA,20,Sardegna,39.21531192,9.110616306,9,0,9,19,28,1,1209,132,1369,63646
2473,6,20,ITA,19,Sicilia,38.11569725,13.3623567,21,5,26,114,140,0,2650,280,3070,157946
2474,6,20,ITA,9,Toscana,43.76923077,11.25588885,19,12,31,383,414,2,8698,1095,10207,215914
2475,6,20,ITA,10,Umbria,43.10675841,12.38824698,5,2,7,10,17,0,1343,78,1438,60857
2476,6,20,ITA,2,Valle d'Aosta,45.73750286,7.320149366,4,0,4,2,6,2,1041,146,1193,13234
2477,6,20,ITA,5,Veneto,45.43490485,12.33845213,27,1,28,547,575,3,16661,2002,19238,387501
2478,6,21,ITA,13,Abruzzo,42.35122196,13.39843823,50,3,53,350,403,0,2419,459,3281,66342
2479,6,21,ITA,17,Basilicata,40.63947052,15.80514834,1,0,1,7,8,0,366,27,401,36515
2480,6,21,ITA,18,Calabria,38.90597598,16.59440194,17,0,17,19,36,6,1040,97,1173,85884
2481,6,21,ITA,15,Campania,40.83956555,14.25084984,41,1,42,84,126,2,4060,431,4617,127385
2482,6,21,ITA,8,Emilia-Romagna,44.49436681,11.3417208,131,12,143,1029,1172,23,22818,4231,28221,270279
2483,6,21,ITA,6,Friuli Venezia Giulia,45.6494354,13.76813649,16,0,16,62,78,1,2883,344,3305,101192
2484,6,21,ITA,12,Lazio,41.89277044,12.48366722,247,39,286,705,991,8,6199,827,8017,259128
2485,6,21,ITA,7,Liguria,44.41149315,8.9326992,59,2,61,187,248,7,8130,1549,9927,73566
2486,6,21,ITA,3,Lombardia,45.46679409,9.190347404,1260,53,1313,12530,13843,128,62555,16570,92968,570750
2487,6,21,ITA,11,Marche,43.61675973,13.5188753,14,0,14,513,527,0,5247,994,6768,77465
2488,6,21,ITA,14,Molise,41.55774754,14.65916051,2,0,2,38,40,0,378,23,441,19644
2489,6,21,ITA,21,P.A. Bolzano,46.49933453,11.35662422,4,1,5,70,75,4,2255,292,2622,38519
2490,6,21,ITA,22,P.A. Trento,46.06893511,11.12123097,0,0,0,53,53,5,3944,466,4463,58345
2491,6,21,ITA,1,Piemonte,45.0732745,7.680687483,356,19,375,1638,2013,26,25177,4051,31241,246075
2492,6,21,ITA,16,Puglia,41.12559576,16.86736689,32,1,33,189,222,2,3765,540,4527,106637
2493,6,21,ITA,20,Sardegna,39.21531192,9.110616306,9,0,9,19,28,0,1209,132,1369,64324
2494,6,21,ITA,19,Sicilia,38.11569725,13.3623567,20,6,26,115,141,2,2651,280,3072,158911
2495,6,21,ITA,9,Toscana,43.76923077,11.25588885,19,9,28,337,365,3,8750,1095,10210,217330
2496,6,21,ITA,10,Umbria,43.10675841,12.38824698,4,1,5,10,15,0,1345,78,1438,61227
2497,6,21,ITA,2,Valle d'Aosta,45.73750286,7.320149366,4,0,4,1,5,0,1042,146,1193,13294
2498,6,21,ITA,5,Veneto,45.43490485,12.33845213,28,1,29,554,583,7,16660,2002,19245,388938
2499,6,22,ITA,13,Abruzzo,42.35122196,13.39843823,49,3,52,342,394,1,2428,460,3282,66466
2500,6,22,ITA,17,Basilicata,40.63947052,15.80514834,1,0,1,7,8,0,366,27,401,36590
2501,6,22,ITA,18,Calabria,38.90597598,16.59440194,15,0,15,18,33,1,1044,97,1174,86321
2502,6,22,ITA,15,Campania,40.83956555,14.25084984,40,0,40,93,133,7,4060,431,4624,127669
2503,6,22,ITA,8,Emilia-Romagna,44.49436681,11.3417208,129,12,141,1013,1154,22,22854,4235,28243,271706
2504,6,22,ITA,6,Friuli Venezia Giulia,45.6494354,13.76813649,15,0,15,57,72,0,2889,344,3305,101622
2505,6,22,ITA,12,Lazio,41.89277044,12.48366722,201,23,224,721,945,8,6250,830,8025,260369
2506,6,22,ITA,7,Liguria,44.41149315,8.9326992,58,1,59,191,250,8,8133,1552,9935,73979
2507,6,22,ITA,3,Lombardia,45.46679409,9.190347404,1047,51,1098,12540,13638,143,62900,16573,93111,575981
2508,6,22,ITA,11,Marche,43.61675973,13.5188753,13,0,13,492,505,3,5275,994,6774,78060
2509,6,22,ITA,14,Molise,41.55774754,14.65916051,3,0,3,40,43,3,378,23,444,19740
2510,6,22,ITA,21,P.A. Bolzano,46.49933453,11.35662422,4,1,5,84,89,11,2252,292,2633,38636
2511,6,22,ITA,22,P.A. Trento,46.06893511,11.12123097,0,0,0,53,53,1,3945,466,4464,58794
2512,6,22,ITA,1,Piemonte,45.0732745,7.680687483,346,19,365,1605,1970,7,25223,4055,31248,246563
2513,6,22,ITA,16,Puglia,41.12559576,16.86736689,33,0,33,185,218,0,3769,540,4527,107702
2514,6,22,ITA,20,Sardegna,39.21531192,9.110616306,9,0,9,19,28,0,1209,132,1369,64582
2515,6,22,ITA,19,Sicilia,38.11569725,13.3623567,20,6,26,115,141,0,2651,280,3072,159796
2516,6,22,ITA,9,Toscana,43.76923077,11.25588885,18,9,27,333,360,1,8752,1099,10211,218271
2517,6,22,ITA,10,Umbria,43.10675841,12.38824698,4,1,5,8,13,0,1347,78,1438,61375
2518,6,22,ITA,2,Valle d'Aosta,45.73750286,7.320149366,4,0,4,1,5,0,1042,146,1193,13294
2519,6,22,ITA,5,Veneto,45.43490485,12.33845213,29,1,30,555,585,2,16659,2003,19247,390386
2520,6,23,ITA,13,Abruzzo,42.35122196,13.39843823,46,3,49,342,391,0,2431,460,3282,67151
2521,6,23,ITA,17,Basilicata,40.63947052,15.80514834,1,0,1,7,8,0,366,27,401,36833
2522,6,23,ITA,18,Calabria,38.90597598,16.59440194,9,0,9,19,28,1,1050,97,1175,87180
2523,6,23,ITA,15,Campania,40.83956555,14.25084984,47,0,47,94,141,10,4062,431,4634,128347
2524,6,23,ITA,8,Emilia-Romagna,44.49436681,11.3417208,121,12,133,956,1089,17,22935,4236,28260,273800
2525,6,23,ITA,6,Friuli Venezia Giulia,45.6494354,13.76813649,14,0,14,57,71,0,2890,344,3305,102267
2526,6,23,ITA,12,Lazio,41.89277044,12.48366722,184,16,200,686,886,8,6315,832,8033,263506
2527,6,23,ITA,7,Liguria,44.41149315,8.9326992,61,1,62,193,255,4,8131,1553,9939,74514
2528,6,23,ITA,3,Lombardia,45.46679409,9.190347404,910,51,961,11942,12903,62,63691,16579,93173,580317
2529,6,23,ITA,11,Marche,43.61675973,13.5188753,11,0,11,482,493,1,5288,994,6775,78583
2530,6,23,ITA,14,Molise,41.55774754,14.65916051,3,0,3,40,43,0,378,23,444,19888
2531,6,23,ITA,21,P.A. Bolzano,46.49933453,11.35662422,3,1,4,85,89,0,2252,292,2633,38949
2532,6,23,ITA,22,P.A. Trento,46.06893511,11.12123097,0,0,0,51,51,1,3948,466,4465,59170
2533,6,23,ITA,1,Piemonte,45.0732745,7.680687483,330,18,348,1522,1870,6,25325,4059,31254,247598
2534,6,23,ITA,16,Puglia,41.12559576,16.86736689,32,0,32,158,190,2,3797,542,4529,109358
2535,6,23,ITA,20,Sardegna,39.21531192,9.110616306,7,0,7,8,15,0,1213,132,1360,65151
2536,6,23,ITA,19,Sicilia,38.11569725,13.3623567,17,5,22,110,132,1,2661,280,3073,161423
2537,6,23,ITA,9,Toscana,43.76923077,11.25588885,20,6,26,311,337,6,8780,1100,10217,219565
2538,6,23,ITA,10,Umbria,43.10675841,12.38824698,4,1,5,7,12,0,1348,78,1438,61929
2539,6,23,ITA,2,Valle d'Aosta,45.73750286,7.320149366,3,0,3,2,5,0,1042,146,1193,13474
2540,6,23,ITA,5,Veneto,45.43490485,12.33845213,30,1,31,533,564,3,16682,2004,19250,392124
2541,6,24,ITA,13,Abruzzo,42.35122196,13.39843823,41,2,43,335,378,1,2444,461,3283,67617
2542,6,24,ITA,17,Basilicata,40.63947052,15.80514834,1,0,1,6,7,0,367,27,401,37107
2543,6,24,ITA,18,Calabria,38.90597598,16.59440194,9,0,9,19,28,0,1050,97,1175,88228
2544,6,24,ITA,15,Campania,40.83956555,14.25084984,35,0,35,113,148,11,4066,431,4645,130025
2545,6,24,ITA,8,Emilia-Romagna,44.49436681,11.3417208,117,12,129,945,1074,44,22985,4245,28304,277700
2546,6,24,ITA,6,Friuli Venezia Giulia,45.6494354,13.76813649,13,0,13,44,57,0,2904,344,3305,103086
2547,6,24,ITA,12,Lazio,41.89277044,12.48366722,181,13,194,675,869,6,6337,833,8039,265507
2548,6,24,ITA,7,Liguria,44.41149315,8.9326992,59,1,60,201,261,1,8124,1555,9940,75134
2549,6,24,ITA,3,Lombardia,45.46679409,9.190347404,692,48,740,11487,12227,88,64448,16586,93261,586567
2550,6,24,ITA,11,Marche,43.61675973,13.5188753,12,0,12,459,471,4,5314,994,6779,79407
2551,6,24,ITA,14,Molise,41.55774754,14.65916051,2,0,2,41,43,0,378,23,444,20247
2552,6,24,ITA,21,P.A. Bolzano,46.49933453,11.35662422,3,1,4,86,90,1,2252,292,2634,39241
2553,6,24,ITA,22,P.A. Trento,46.06893511,11.12123097,0,0,0,52,52,0,4395,405,4852,59700
2554,6,24,ITA,1,Piemonte,45.0732745,7.680687483,334,18,352,1378,1730,22,25480,4066,31276,249804
2555,6,24,ITA,16,Puglia,41.12559576,16.86736689,29,0,29,148,177,0,3809,543,4529,111420
2556,6,24,ITA,20,Sardegna,39.21531192,9.110616306,7,0,7,8,15,1,1214,132,1361,66202
2557,6,24,ITA,19,Sicilia,38.11569725,13.3623567,17,5,22,110,132,1,2662,280,3074,162675
2558,6,24,ITA,9,Toscana,43.76923077,11.25588885,26,5,31,299,330,5,8791,1101,10222,221190
2559,6,24,ITA,10,Umbria,43.10675841,12.38824698,3,1,4,7,11,1,1349,79,1439,62477
2560,6,24,ITA,2,Valle d'Aosta,45.73750286,7.320149366,3,0,3,3,6,1,1042,146,1194,13497
2561,6,24,ITA,5,Veneto,45.43490485,12.33845213,26,1,27,522,549,3,16700,2004,19253,394533
2562,6,25,ITA,13,Abruzzo,42.35122196,13.39843823,32,2,34,337,371,1,2452,461,3284,68098
2563,6,25,ITA,17,Basilicata,40.63947052,15.80514834,1,0,1,6,7,0,367,27,401,37481
2564,6,25,ITA,18,Calabria,38.90597598,16.59440194,10,0,10,18,28,0,1050,97,1175,89249
2565,6,25,ITA,15,Campania,40.83956555,14.25084984,47,0,47,117,164,17,4067,431,4662,131319
2566,6,25,ITA,8,Emilia-Romagna,44.49436681,11.3417208,114,11,125,943,1068,47,23034,4249,28351,282325
2567,6,25,ITA,6,Friuli Venezia Giulia,45.6494354,13.76813649,12,0,12,41,53,0,2907,345,3305,103759
2568,6,25,ITA,12,Lazio,41.89277044,12.48366722,181,12,193,669,862,12,6354,835,8051,267089
2569,6,25,ITA,7,Liguria,44.41149315,8.9326992,56,1,57,202,259,14,8139,1556,9954,75828
2570,6,25,ITA,3,Lombardia,45.46679409,9.190347404,622,48,670,11322,11992,170,64831,16608,93431,592797
2571,6,25,ITA,11,Marche,43.61675973,13.5188753,10,0,10,450,460,2,5330,991,6781,80229
2572,6,25,ITA,14,Molise,41.55774754,14.65916051,2,0,2,34,36,0,385,23,444,20460
2573,6,25,ITA,21,P.A. Bolzano,46.49933453,11.35662422,3,1,4,83,87,0,2255,292,2634,39601
2574,6,25,ITA,22,P.A. Trento,46.06893511,11.12123097,1,0,1,51,52,3,4398,405,4855,60448
2575,6,25,ITA,1,Piemonte,45.0732745,7.680687483,316,15,331,1350,1681,20,25544,4071,31296,252094
2576,6,25,ITA,16,Puglia,41.12559576,16.86736689,27,0,27,146,173,1,3814,543,4530,112532
2577,6,25,ITA,20,Sardegna,39.21531192,9.110616306,6,0,6,8,14,1,1216,132,1362,67025
2578,6,25,ITA,19,Sicilia,38.11569725,13.3623567,17,5,22,108,130,2,2666,280,3076,163991
2579,6,25,ITA,9,Toscana,43.76923077,11.25588885,24,6,30,294,324,2,8799,1101,10224,222294
2580,6,25,ITA,10,Umbria,43.10675841,12.38824698,3,1,4,6,10,0,1350,79,1439,63068
2581,6,25,ITA,2,Valle d'Aosta,45.73750286,7.320149366,2,0,2,3,5,0,1043,146,1194,13560
2582,6,25,ITA,5,Veneto,45.43490485,12.33845213,29,1,30,497,527,4,16724,2006,19257,397538
2583,6,26,ITA,13,Abruzzo,42.35122196,13.39843823,30,2,32,326,358,1,2466,461,3285,68584
2584,6,26,ITA,17,Basilicata,40.63947052,15.80514834,1,0,1,6,7,0,367,27,401,37910
2585,6,26,ITA,18,Calabria,38.90597598,16.59440194,9,0,9,21,30,3,1051,97,1178,90414
2586,6,26,ITA,15,Campania,40.83956555,14.25084984,41,1,42,122,164,3,4070,431,4665,131984
2587,6,26,ITA,8,Emilia-Romagna,44.49436681,11.3417208,109,12,121,923,1044,46,23097,4252,28393,285701
2588,6,26,ITA,6,Friuli Venezia Giulia,45.6494354,13.76813649,13,0,13,35,48,2,2914,345,3307,104501
2589,6,26,ITA,12,Lazio,41.89277044,12.48366722,185,13,198,618,816,13,6412,836,8064,269189
2590,6,26,ITA,7,Liguria,44.41149315,8.9326992,54,3,57,207,264,4,8138,1556,9958,76437
2591,6,26,ITA,3,Lombardia,45.46679409,9.190347404,501,47,548,11092,11640,156,65323,16624,93587,600985
2592,6,26,ITA,11,Marche,43.61675973,13.5188753,10,0,10,397,407,2,5385,991,6783,80847
2593,6,26,ITA,14,Molise,41.55774754,14.65916051,1,0,1,28,29,1,393,23,445,20958
2594,6,26,ITA,21,P.A. Bolzano,46.49933453,11.35662422,3,1,4,81,85,0,2257,292,2634,39893
2595,6,26,ITA,22,P.A. Trento,46.06893511,11.12123097,1,0,1,51,52,4,4402,405,4859,60783
2596,6,26,ITA,1,Piemonte,45.0732745,7.680687483,307,14,321,1264,1585,15,25649,4077,31311,253971
2597,6,26,ITA,16,Puglia,41.12559576,16.86736689,27,0,27,126,153,1,3835,543,4531,113789
2598,6,26,ITA,20,Sardegna,39.21531192,9.110616306,5,0,5,7,12,0,1218,132,1362,67848
2599,6,26,ITA,19,Sicilia,38.11569725,13.3623567,18,4,22,107,129,0,2666,281,3076,165403
2600,6,26,ITA,9,Toscana,43.76923077,11.25588885,21,6,27,287,314,2,8809,1103,10226,223804
2601,6,26,ITA,10,Umbria,43.10675841,12.38824698,2,1,3,7,10,1,1351,79,1440,63545
2602,6,26,ITA,2,Valle d'Aosta,45.73750286,7.320149366,2,0,2,2,4,0,1044,146,1194,13610
2603,6,26,ITA,5,Veneto,45.43490485,12.33845213,16,1,17,470,487,5,16768,2007,19262,398960
2604,6,27,ITA,13,Abruzzo,42.35122196,13.39843823,31,2,33,304,337,0,2487,461,3285,69214
2605,6,27,ITA,17,Basilicata,40.63947052,15.80514834,1,0,1,6,7,0,367,27,401,38221
2606,6,27,ITA,18,Calabria,38.90597598,16.59440194,9,0,9,22,31,1,1051,97,1179,91388
2607,6,27,ITA,15,Campania,40.83956555,14.25084984,45,0,45,118,163,0,4071,431,4665,133632
2608,6,27,ITA,8,Emilia-Romagna,44.49436681,11.3417208,106,11,117,924,1041,42,23142,4252,28435,288719
2609,6,27,ITA,6,Friuli Venezia Giulia,45.6494354,13.76813649,12,0,12,30,42,0,2920,345,3307,105108
2610,6,27,ITA,12,Lazio,41.89277044,12.48366722,185,13,198,629,827,18,6418,837,8082,271209
2611,6,27,ITA,7,Liguria,44.41149315,8.9326992,49,3,52,216,268,5,8138,1557,9963,77180
2612,6,27,ITA,3,Lombardia,45.46679409,9.190347404,415,43,458,10534,10992,77,66046,16626,93664,606607
2613,6,27,ITA,11,Marche,43.61675973,13.5188753,9,0,9,348,357,2,5437,991,6785,81511
2614,6,27,ITA,14,Molise,41.55774754,14.65916051,0,0,0,26,26,0,396,23,445,21165
2615,6,27,ITA,21,P.A. Bolzano,46.49933453,11.35662422,4,1,5,82,87,2,2257,292,2636,40235
2616,6,27,ITA,22,P.A. Trento,46.06893511,11.12123097,2,0,2,49,51,1,4404,405,4860,61511
2617,6,27,ITA,1,Piemonte,45.0732745,7.680687483,303,12,315,1188,1503,11,25739,4080,31322,255473
2618,6,27,ITA,16,Puglia,41.12559576,16.86736689,27,0,27,120,147,0,3841,543,4531,115265
2619,6,27,ITA,20,Sardegna,39.21531192,9.110616306,6,0,6,7,13,1,1218,132,1363,68359
2620,6,27,ITA,19,Sicilia,38.11569725,13.3623567,20,4,24,106,130,1,2666,281,3077,167299
2621,6,27,ITA,9,Toscana,43.76923077,11.25588885,14,6,20,298,318,12,8817,1103,10238,225524
2622,6,27,ITA,10,Umbria,43.10675841,12.38824698,2,1,3,7,10,0,1350,80,1440,64026
2623,6,27,ITA,2,Valle d'Aosta,45.73750286,7.320149366,2,0,2,2,4,0,1044,146,1194,13635
2624,6,27,ITA,5,Veneto,45.43490485,12.33845213,18,1,19,463,482,2,16775,2007,19264,403556
2625,6,28,ITA,13,Abruzzo,42.35122196,13.39843823,28,2,30,254,284,1,2540,462,3286,69720
2626,6,28,ITA,17,Basilicata,40.63947052,15.80514834,1,0,1,1,2,0,372,27,401,38358
2627,6,28,ITA,18,Calabria,38.90597598,16.59440194,4,0,4,22,26,1,1057,97,1180,91818
2628,6,28,ITA,15,Campania,40.83956555,14.25084984,39,0,39,124,163,0,4071,431,4665,134651
2629,6,28,ITA,8,Emilia-Romagna,44.49436681,11.3417208,108,12,120,922,1042,21,23161,4253,28456,291041
2630,6,28,ITA,6,Friuli Venezia Giulia,45.6494354,13.76813649,12,0,12,26,38,1,2925,345,3308,105492
2631,6,28,ITA,12,Lazio,41.89277044,12.48366722,187,13,200,641,841,14,6418,837,8096,272915
2632,6,28,ITA,7,Liguria,44.41149315,8.9326992,48,3,51,221,272,4,8137,1558,9967,77675
2633,6,28,ITA,3,Lombardia,45.46679409,9.190347404,323,43,366,10581,10947,97,66175,16639,93761,611487
2634,6,28,ITA,11,Marche,43.61675973,13.5188753,9,0,9,311,320,0,5474,991,6785,82147
2635,6,28,ITA,14,Molise,41.55774754,14.65916051,0,0,0,26,26,0,396,23,445,21325
2636,6,28,ITA,21,P.A. Bolzano,46.49933453,11.35662422,3,1,4,81,85,1,2260,292,2637,40487
2637,6,28,ITA,22,P.A. Trento,46.06893511,11.12123097,2,0,2,52,54,3,4404,405,4863,62021
2638,6,28,ITA,1,Piemonte,45.0732745,7.680687483,305,12,317,1178,1495,14,25756,4085,31336,257049
2639,6,28,ITA,16,Puglia,41.12559576,16.86736689,27,0,27,119,146,0,3842,543,4531,116126
2640,6,28,ITA,20,Sardegna,39.21531192,9.110616306,6,0,6,8,14,1,1218,132,1364,69088
2641,6,28,ITA,19,Sicilia,38.11569725,13.3623567,21,4,25,105,130,0,2666,281,3077,168323
2642,6,28,ITA,9,Toscana,43.76923077,11.25588885,16,6,22,301,323,5,8817,1103,10243,227034
2643,6,28,ITA,10,Umbria,43.10675841,12.38824698,2,1,3,6,9,0,1351,80,1440,64456
2644,6,28,ITA,2,Valle d'Aosta,45.73750286,7.320149366,3,0,3,1,4,0,1044,146,1194,13681
2645,6,28,ITA,5,Veneto,45.43490485,12.33845213,16,1,17,443,460,11,16807,2008,19275,405126
2646,6,29,ITA,13,Abruzzo,42.35122196,13.39843823,28,2,30,252,282,1,2543,462,3287,69874
2647,6,29,ITA,17,Basilicata,40.63947052,15.80514834,1,0,1,2,3,1,372,27,402,38514
2648,6,29,ITA,18,Calabria,38.90597598,16.59440194,4,0,4,22,26,0,1057,97,1180,92136
2649,6,29,ITA,15,Campania,40.83956555,14.25084984,20,0,20,142,162,1,4073,431,4666,135740
2650,6,29,ITA,8,Emilia-Romagna,44.49436681,11.3417208,111,12,123,909,1032,16,23185,4255,28472,292851
2651,6,29,ITA,6,Friuli Venezia Giulia,45.6494354,13.76813649,12,0,12,24,36,0,2927,345,3308,105815
2652,6,29,ITA,12,Lazio,41.89277044,12.48366722,190,13,203,637,840,9,6428,837,8105,274704
2653,6,29,ITA,7,Liguria,44.41149315,8.9326992,47,3,50,227,277,7,8139,1558,9974,78097
2654,6,29,ITA,3,Lombardia,45.46679409,9.190347404,321,43,364,10459,10823,78,66376,16640,93839,615813
2655,6,29,ITA,11,Marche,43.61675973,13.5188753,9,0,9,265,274,0,5520,991,6785,82326
2656,6,29,ITA,14,Molise,41.55774754,14.65916051,0,0,0,26,26,0,396,23,445,21400
2657,6,29,ITA,21,P.A. Bolzano,46.49933453,11.35662422,2,1,3,82,85,2,2262,292,2639,40655
2658,6,29,ITA,22,P.A. Trento,46.06893511,11.12123097,1,0,1,52,53,0,4405,405,4863,62092
2659,6,29,ITA,1,Piemonte,45.0732745,7.680687483,283,11,294,1196,1490,2,25761,4087,31338,257579
2660,6,29,ITA,16,Puglia,41.12559576,16.86736689,28,0,28,117,145,0,3843,543,4531,117104
2661,6,29,ITA,20,Sardegna,39.21531192,9.110616306,6,0,6,8,14,0,1218,132,1364,69332
2662,6,29,ITA,19,Sicilia,38.11569725,13.3623567,21,3,24,103,127,1,2670,281,3078,169019
2663,6,29,ITA,9,Toscana,43.76923077,11.25588885,14,6,20,307,327,5,8817,1104,10248,228057
2664,6,29,ITA,10,Umbria,43.10675841,12.38824698,2,1,3,6,9,0,1351,80,1440,64620
2665,6,29,ITA,2,Valle d'Aosta,45.73750286,7.320149366,3,0,3,0,3,0,1045,146,1194,13734
2666,6,29,ITA,5,Veneto,45.43490485,12.33845213,17,1,18,444,462,3,16808,2008,19278,406042
2667,6,30,ITA,13,Abruzzo,42.35122196,13.39843823,33,0,33,164,197,0,2626,464,3287,70443
2668,6,30,ITA,17,Basilicata,40.63947052,15.80514834,1,0,1,2,3,0,372,27,402,38851
2669,6,30,ITA,18,Calabria,38.90597598,16.59440194,4,0,4,23,27,1,1057,97,1181,93060
2670,6,30,ITA,15,Campania,40.83956555,14.25084984,29,0,29,152,181,24,4077,432,4690,138482
2671,6,30,ITA,8,Emilia-Romagna,44.49436681,11.3417208,108,12,120,890,1010,20,23222,4260,28492,296112
2672,6,30,ITA,6,Friuli Venezia Giulia,45.6494354,13.76813649,9,0,9,36,45,0,2918,345,3308,106632
2673,6,30,ITA,12,Lazio,41.89277044,12.48366722,189,13,202,634,836,5,6437,837,8110,276640
2674,6,30,ITA,7,Liguria,44.41149315,8.9326992,46,3,49,231,280,3,8139,1558,9977,78710
2675,6,30,ITA,3,Lombardia,45.46679409,9.190347404,297,42,339,9721,10060,62,67197,16644,93901,619851
2676,6,30,ITA,11,Marche,43.61675973,13.5188753,8,0,8,258,266,0,5528,991,6785,82950
2677,6,30,ITA,14,Molise,41.55774754,14.65916051,0,0,0,25,25,0,397,23,445,21585
2678,6,30,ITA,21,P.A. Bolzano,46.49933453,11.35662422,3,1,4,80,84,0,2263,292,2639,40961
2679,6,30,ITA,22,P.A. Trento,46.06893511,11.12123097,1,0,1,49,50,0,4408,405,4863,62918
2680,6,30,ITA,1,Piemonte,45.0732745,7.680687483,267,12,279,1144,1423,11,25836,4090,31349,259420
2681,6,30,ITA,16,Puglia,41.12559576,16.86736689,25,0,25,104,129,0,3857,545,4531,118741
2682,6,30,ITA,20,Sardegna,39.21531192,9.110616306,6,0,6,8,14,2,1219,133,1366,70030
2683,6,30,ITA,19,Sicilia,38.11569725,13.3623567,19,3,22,106,128,2,2670,282,3080,171130
2684,6,30,ITA,9,Toscana,43.76923077,11.25588885,17,6,23,306,329,2,8817,1104,10250,229809
2685,6,30,ITA,10,Umbria,43.10675841,12.38824698,3,1,4,6,10,1,1351,80,1441,65217
2686,6,30,ITA,2,Valle d'Aosta,45.73750286,7.320149366,4,0,4,0,4,1,1045,146,1195,13805
2687,6,30,ITA,5,Veneto,45.43490485,12.33845213,21,0,21,441,462,8,16812,2012,19286,408628
2688,7,1,ITA,13,Abruzzo,42.35122196,13.39843823,32,0,32,138,170,2,2655,464,3289,70898
2689,7,1,ITA,17,Basilicata,40.63947052,15.80514834,0,0,0,2,2,0,373,27,402,39007
2690,7,1,ITA,18,Calabria,38.90597598,16.59440194,4,0,4,22,26,0,1058,97,1181,93892
2691,7,1,ITA,15,Campania,40.83956555,14.25084984,16,0,16,173,189,9,4078,432,4699,139678
2692,7,1,ITA,8,Emilia-Romagna,44.49436681,11.3417208,104,10,114,888,1002,16,23242,4264,28508,298840
2693,7,1,ITA,6,Friuli Venezia Giulia,45.6494354,13.76813649,6,0,6,50,56,4,2911,345,3312,107364
2694,7,1,ITA,12,Lazio,41.89277044,12.48366722,190,12,202,630,832,9,6448,839,8119,279387
2695,7,1,ITA,7,Liguria,44.41149315,8.9326992,42,3,45,235,280,5,8144,1558,9982,79497
2696,7,1,ITA,3,Lombardia,45.46679409,9.190347404,277,41,318,9620,9938,109,67422,16650,94010,625197
2697,7,1,ITA,11,Marche,43.61675973,13.5188753,8,0,8,240,248,5,5551,987,6786,83726
2698,7,1,ITA,14,Molise,41.55774754,14.65916051,0,0,0,25,25,0,397,23,445,21809
2699,7,1,ITA,21,P.A. Bolzano,46.49933453,11.35662422,3,1,4,80,84,3,2266,292,2642,41389
2700,7,1,ITA,22,P.A. Trento,46.06893511,11.12123097,1,0,1,46,47,1,4412,405,4864,63299
2701,7,1,ITA,1,Piemonte,45.0732745,7.680687483,260,11,271,1082,1353,16,25921,4091,31365,261774
2702,7,1,ITA,16,Puglia,41.12559576,16.86736689,24,0,24,88,112,0,3873,545,4530,120651
2703,7,1,ITA,20,Sardegna,39.21531192,9.110616306,5,0,5,6,11,0,1222,133,1366,71039
2704,7,1,ITA,19,Sicilia,38.11569725,13.3623567,18,3,21,105,126,1,2673,282,3081,172947
2705,7,1,ITA,9,Toscana,43.76923077,11.25588885,13,5,18,305,323,4,8825,1106,10254,231407
2706,7,1,ITA,10,Umbria,43.10675841,12.38824698,3,1,4,6,10,0,1351,80,1441,65770
2707,7,1,ITA,2,Valle d'Aosta,45.73750286,7.320149366,2,0,2,1,3,0,1046,146,1195,13892
2708,7,1,ITA,5,Veneto,45.43490485,12.33845213,17,0,17,401,418,3,16849,2022,19289,411837
2709,7,2,ITA,13,Abruzzo,42.35122196,13.39843823,28,0,28,132,160,3,2668,464,3292,71520
2710,7,2,ITA,17,Basilicata,40.63947052,15.80514834,0,0,0,2,2,0,373,27,402,39261
2711,7,2,ITA,18,Calabria,38.90597598,16.59440194,4,0,4,21,25,0,1059,97,1181,94880
2712,7,2,ITA,15,Campania,40.83956555,14.25084984,15,0,15,175,190,3,4080,432,4702,140525
2713,7,2,ITA,8,Emilia-Romagna,44.49436681,11.3417208,96,9,105,898,1003,27,23267,4265,28535,301588
2714,7,2,ITA,6,Friuli Venezia Giulia,45.6494354,13.76813649,6,0,6,56,62,2,2907,345,3314,107907
2715,7,2,ITA,12,Lazio,41.89277044,12.48366722,188,11,199,632,831,11,6460,839,8130,281743
2716,7,2,ITA,7,Liguria,44.41149315,8.9326992,41,3,44,237,281,2,8145,1558,9984,80201
2717,7,2,ITA,3,Lombardia,45.46679409,9.190347404,241,41,282,9545,9827,98,67610,16671,94108,630993
2718,7,2,ITA,11,Marche,43.61675973,13.5188753,8,0,8,230,238,3,5564,987,6789,84572
2719,7,2,ITA,14,Molise,41.55774754,14.65916051,0,0,0,21,21,0,401,23,445,22013
2720,7,2,ITA,21,P.A. Bolzano,46.49933453,11.35662422,3,0,3,81,84,0,2266,292,2642,41686
2721,7,2,ITA,22,P.A. Trento,46.06893511,11.12123097,1,0,1,45,46,1,4414,405,4865,63787
2722,7,2,ITA,1,Piemonte,45.0732745,7.680687483,248,11,259,1040,1299,13,25983,4096,31378,263385
2723,7,2,ITA,16,Puglia,41.12559576,16.86736689,24,0,24,85,109,0,3876,545,4530,122302
2724,7,2,ITA,20,Sardegna,39.21531192,9.110616306,7,0,7,6,13,2,1222,133,1368,72197
2725,7,2,ITA,19,Sicilia,38.11569725,13.3623567,17,3,20,114,134,9,2674,282,3090,174795
2726,7,2,ITA,9,Toscana,43.76923077,11.25588885,11,3,14,310,324,4,8825,1109,10258,232951
2727,7,2,ITA,10,Umbria,43.10675841,12.38824698,3,1,4,7,11,3,1353,80,1444,66402
2728,7,2,ITA,2,Valle d'Aosta,45.73750286,7.320149366,2,0,2,1,3,0,1046,146,1195,13911
2729,7,2,ITA,5,Veneto,45.43490485,12.33845213,20,0,20,377,397,20,16890,2022,19309,415828
2730,7,3,ITA,13,Abruzzo,42.35122196,13.39843823,27,0,27,129,156,6,2678,464,3298,71976
2731,7,3,ITA,17,Basilicata,40.63947052,15.80514834,0,0,0,4,4,2,373,27,404,39553
2732,7,3,ITA,18,Calabria,38.90597598,16.59440194,4,0,4,21,25,1,1060,97,1182,95818
2733,7,3,ITA,15,Campania,40.83956555,14.25084984,35,0,35,162,197,10,4083,432,4712,142219
2734,7,3,ITA,8,Emilia-Romagna,44.49436681,11.3417208,87,9,96,915,1011,27,23284,4267,28562,304202
2735,7,3,ITA,6,Friuli Venezia Giulia,45.6494354,13.76813649,6,0,6,62,68,4,2905,345,3318,108444
2736,7,3,ITA,12,Lazio,41.89277044,12.48366722,188,11,199,627,826,11,6475,840,8141,283710
2737,7,3,ITA,7,Liguria,44.41149315,8.9326992,40,3,43,240,283,3,8146,1558,9987,80887
2738,7,3,ITA,3,Lombardia,45.46679409,9.190347404,241,41,282,9395,9677,115,67871,16675,94223,636860
2739,7,3,ITA,11,Marche,43.61675973,13.5188753,6,0,6,221,227,0,5575,987,6789,85256
2740,7,3,ITA,14,Molise,41.55774754,14.65916051,0,0,0,21,21,0,401,23,445,22167
2741,7,3,ITA,21,P.A. Bolzano,46.49933453,11.35662422,3,0,3,80,83,0,2267,292,2642,42017
2742,7,3,ITA,22,P.A. Trento,46.06893511,11.12123097,2,0,2,44,46,6,4420,405,4871,64218
2743,7,3,ITA,1,Piemonte,45.0732745,7.680687483,235,10,245,1030,1275,16,26019,4100,31394,264608
2744,7,3,ITA,16,Puglia,41.12559576,16.86736689,21,0,21,88,109,3,3879,545,4533,123414
2745,7,3,ITA,20,Sardegna,39.21531192,9.110616306,6,0,6,8,14,1,1222,133,1369,72993
2746,7,3,ITA,19,Sicilia,38.11569725,13.3623567,16,2,18,117,135,1,2674,282,3091,176956
2747,7,3,ITA,9,Toscana,43.76923077,11.25588885,13,3,16,307,323,9,8832,1112,10267,234084
2748,7,3,ITA,10,Umbria,43.10675841,12.38824698,4,0,4,6,10,2,1356,80,1446,66783
2749,7,3,ITA,2,Valle d'Aosta,45.73750286,7.320149366,3,0,3,1,4,1,1046,146,1196,13966
2750,7,3,ITA,5,Veneto,45.43490485,12.33845213,19,0,19,371,390,5,16901,2023,19314,417996
2751,7,4,ITA,13,Abruzzo,42.35122196,13.39843823,28,0,28,131,159,7,2682,464,3305,72652
2752,7,4,ITA,17,Basilicata,40.63947052,15.80514834,0,0,0,4,4,0,373,27,404,39782
2753,7,4,ITA,18,Calabria,38.90597598,16.59440194,3,0,3,23,26,1,1060,97,1183,96902
2754,7,4,ITA,15,Campania,40.83956555,14.25084984,37,0,37,161,198,2,4084,432,4714,143232
2755,7,4,ITA,8,Emilia-Romagna,44.49436681,11.3417208,88,8,96,941,1037,51,23309,4267,28613,307615
2756,7,4,ITA,6,Friuli Venezia Giulia,45.6494354,13.76813649,6,0,6,67,73,8,2908,345,3326,109076
2757,7,4,ITA,12,Lazio,41.89277044,12.48366722,197,11,208,646,854,31,6477,841,8172,285697
2758,7,4,ITA,7,Liguria,44.41149315,8.9326992,39,2,41,242,283,4,8150,1558,9991,81739
2759,7,4,ITA,3,Lombardia,45.46679409,9.190347404,231,36,267,9159,9426,95,68201,16691,94318,642762
2760,7,4,ITA,11,Marche,43.61675973,13.5188753,5,0,5,198,203,0,5599,987,6789,85913
2761,7,4,ITA,14,Molise,41.55774754,14.65916051,0,0,0,21,21,0,401,23,445,22303
2762,7,4,ITA,21,P.A. Bolzano,46.49933453,11.35662422,3,0,3,82,85,3,2268,292,2645,42385
2763,7,4,ITA,22,P.A. Trento,46.06893511,11.12123097,2,0,2,46,48,2,4420,405,4873,64691
2764,7,4,ITA,1,Piemonte,45.0732745,7.680687483,225,9,234,983,1217,11,26086,4102,31405,266238
2765,7,4,ITA,16,Puglia,41.12559576,16.86736689,21,0,21,90,111,3,3880,545,4536,125029
2766,7,4,ITA,20,Sardegna,39.21531192,9.110616306,6,0,6,7,13,0,1223,133,1369,73703
2767,7,4,ITA,19,Sicilia,38.11569725,13.3623567,15,2,17,121,138,3,2674,282,3094,179117
2768,7,4,ITA,9,Toscana,43.76923077,11.25588885,11,2,13,311,324,9,8838,1114,10276,235764
2769,7,4,ITA,10,Umbria,43.10675841,12.38824698,4,0,4,5,9,1,1358,80,1447,67231
2770,7,4,ITA,2,Valle d'Aosta,45.73750286,7.320149366,3,0,3,1,4,0,1046,146,1196,14000
2771,7,4,ITA,5,Veneto,45.43490485,12.33845213,16,1,17,371,388,4,16907,2023,19318,421242
2772,7,5,ITA,13,Abruzzo,42.35122196,13.39843823,30,0,30,133,163,4,2682,464,3309,73142
2773,7,5,ITA,17,Basilicata,40.63947052,15.80514834,0,0,0,4,4,0,373,27,404,39782
2774,7,5,ITA,18,Calabria,38.90597598,16.59440194,3,0,3,23,26,0,1060,97,1183,97433
2775,7,5,ITA,15,Campania,40.83956555,14.25084984,36,0,36,165,201,5,4086,432,4719,144281
2776,7,5,ITA,8,Emilia-Romagna,44.49436681,11.3417208,88,9,97,932,1029,24,23340,4268,28637,309970
2777,7,5,ITA,6,Friuli Venezia Giulia,45.6494354,13.76813649,7,0,7,66,73,0,2908,345,3326,109389
2778,7,5,ITA,12,Lazio,41.89277044,12.48366722,199,11,210,651,861,14,6484,841,8186,287673
2779,7,5,ITA,7,Liguria,44.41149315,8.9326992,43,3,46,243,289,8,8152,1558,9999,82338
2780,7,5,ITA,3,Lombardia,45.46679409,9.190347404,230,36,266,9179,9445,98,68274,16697,94416,647739
2781,7,5,ITA,11,Marche,43.61675973,13.5188753,5,0,5,189,194,1,5609,987,6790,86515
2782,7,5,ITA,14,Molise,41.55774754,14.65916051,0,0,0,21,21,0,401,23,445,22432
2783,7,5,ITA,21,P.A. Bolzano,46.49933453,11.35662422,3,0,3,82,85,2,2270,292,2647,42772
2784,7,5,ITA,22,P.A. Trento,46.06893511,11.12123097,2,0,2,40,42,0,4426,405,4873,65033
2785,7,5,ITA,1,Piemonte,45.0732745,7.680687483,226,9,235,982,1217,18,26104,4102,31423,267961
2786,7,5,ITA,16,Puglia,41.12559576,16.86736689,20,0,20,90,110,0,3881,545,4536,125961
2787,7,5,ITA,20,Sardegna,39.21531192,9.110616306,4,0,4,8,12,1,1225,133,1370,74074
2788,7,5,ITA,19,Sicilia,38.11569725,13.3623567,13,2,15,123,138,0,2674,282,3094,180132
2789,7,5,ITA,9,Toscana,43.76923077,11.25588885,12,2,14,316,330,9,8841,1114,10285,237344
2790,7,5,ITA,10,Umbria,43.10675841,12.38824698,4,0,4,5,9,0,1358,80,1447,67644
2791,7,5,ITA,2,Valle d'Aosta,45.73750286,7.320149366,4,0,4,1,5,0,1045,146,1196,14039
2792,7,5,ITA,5,Veneto,45.43490485,12.33845213,16,2,18,370,388,8,16915,2023,19326,422585
2793,7,6,ITA,13,Abruzzo,42.35122196,13.39843823,30,0,30,126,156,0,2689,464,3309,73199
2794,7,6,ITA,17,Basilicata,40.63947052,15.80514834,0,0,0,4,4,0,373,27,404,40027
2795,7,6,ITA,18,Calabria,38.90597598,16.59440194,4,0,4,22,26,0,1060,97,1183,97671
2796,7,6,ITA,15,Campania,40.83956555,14.25084984,42,0,42,185,227,27,4087,432,4746,144742
2797,7,6,ITA,8,Emilia-Romagna,44.49436681,11.3417208,90,9,99,965,1064,38,23343,4268,28675,311431
2798,7,6,ITA,6,Friuli Venezia Giulia,45.6494354,13.76813649,9,0,9,62,71,0,2910,345,3326,109777
2799,7,6,ITA,12,Lazio,41.89277044,12.48366722,200,12,212,658,870,19,6493,842,8205,289493
2800,7,6,ITA,7,Liguria,44.41149315,8.9326992,46,0,46,243,289,2,8154,1558,10001,82633
2801,7,6,ITA,3,Lombardia,45.46679409,9.190347404,233,36,269,9223,9492,111,68335,16700,94527,651688
2802,7,6,ITA,11,Marche,43.61675973,13.5188753,5,0,5,184,189,0,5614,987,6790,86700
2803,7,6,ITA,14,Molise,41.55774754,14.65916051,0,0,0,21,21,0,401,23,445,22519
2804,7,6,ITA,21,P.A. Bolzano,46.49933453,11.35662422,3,0,3,80,83,0,2272,292,2647,42875
2805,7,6,ITA,22,P.A. Trento,46.06893511,11.12123097,3,0,3,34,37,0,4431,405,4873,65130
2806,7,6,ITA,1,Piemonte,45.0732745,7.680687483,210,9,219,989,1208,6,26117,4104,31429,268189
2807,7,6,ITA,16,Puglia,41.12559576,16.86736689,18,0,18,75,93,0,3898,545,4536,127514
2808,7,6,ITA,20,Sardegna,39.21531192,9.110616306,3,0,3,7,10,1,1227,134,1371,74361
2809,7,6,ITA,19,Sicilia,38.11569725,13.3623567,14,2,16,123,139,1,2674,282,3095,180811
2810,7,6,ITA,9,Toscana,43.76923077,11.25588885,12,2,14,318,332,2,8841,1114,10287,238175
2811,7,6,ITA,10,Umbria,43.10675841,12.38824698,4,0,4,5,9,0,1358,80,1447,67791
2812,7,6,ITA,2,Valle d'Aosta,45.73750286,7.320149366,4,0,4,1,5,0,1045,146,1196,14101
2813,7,6,ITA,5,Veneto,45.43490485,12.33845213,16,2,18,366,384,1,16919,2024,19327,423183
2814,7,7,ITA,13,Abruzzo,42.35122196,13.39843823,28,0,28,125,153,0,2692,464,3309,73722
2815,7,7,ITA,17,Basilicata,40.63947052,15.80514834,0,0,0,4,4,0,373,27,404,40322
2816,7,7,ITA,18,Calabria,38.90597598,16.59440194,4,0,4,23,27,1,1060,97,1184,98703
2817,7,7,ITA,15,Campania,40.83956555,14.25084984,48,0,48,178,226,1,4089,432,4747,145538
2818,7,7,ITA,8,Emilia-Romagna,44.49436681,11.3417208,98,10,108,952,1060,31,23377,4269,28706,314717
2819,7,7,ITA,6,Friuli Venezia Giulia,45.6494354,13.76813649,7,0,7,65,72,1,2910,345,3327,110428
2820,7,7,ITA,12,Lazio,41.89277044,12.48366722,202,13,215,658,873,5,6495,842,8210,291236
2821,7,7,ITA,7,Liguria,44.41149315,8.9326992,38,0,38,247,285,2,8160,1558,10003,83387
2822,7,7,ITA,3,Lombardia,45.46679409,9.190347404,229,36,265,8809,9074,53,68793,16713,94580,653837
2823,7,7,ITA,11,Marche,43.61675973,13.5188753,5,0,5,180,185,1,5619,987,6791,87246
2824,7,7,ITA,14,Molise,41.55774754,14.65916051,0,0,0,18,18,0,404,23,445,22691
2825,7,7,ITA,21,P.A. Bolzano,46.49933453,11.35662422,3,0,3,80,83,1,2273,292,2648,43059
2826,7,7,ITA,22,P.A. Trento,46.06893511,11.12123097,3,0,3,37,40,3,4431,405,4876,65442
2827,7,7,ITA,1,Piemonte,45.0732745,7.680687483,210,8,218,955,1173,5,26154,4107,31434,269654
2828,7,7,ITA,16,Puglia,41.12559576,16.86736689,12,0,12,67,79,0,3910,546,4535,128899
2829,7,7,ITA,20,Sardegna,39.21531192,9.110616306,5,0,5,8,13,0,1224,134,1371,75144
2830,7,7,ITA,19,Sicilia,38.11569725,13.3623567,12,0,12,128,140,1,2674,282,3096,182429
2831,7,7,ITA,9,Toscana,43.76923077,11.25588885,12,1,13,326,339,19,8851,1116,10306,239793
2832,7,7,ITA,10,Umbria,43.10675841,12.38824698,3,0,3,5,8,0,1359,80,1447,68353
2833,7,7,ITA,2,Valle d'Aosta,45.73750286,7.320149366,4,0,4,1,5,0,1045,146,1196,14138
2834,7,7,ITA,5,Veneto,45.43490485,12.33845213,17,2,19,366,385,14,16922,2034,19341,425762
2835,7,8,ITA,13,Abruzzo,42.35122196,13.39843823,27,0,27,118,145,1,2701,464,3310,74235
2836,7,8,ITA,17,Basilicata,40.63947052,15.80514834,1,0,1,4,5,1,373,27,405,40550
2837,7,8,ITA,18,Calabria,38.90597598,16.59440194,4,0,4,24,28,1,1060,97,1185,99608
2838,7,8,ITA,15,Campania,40.83956555,14.25084984,36,0,36,192,228,3,4090,432,4750,146632
2839,7,8,ITA,8,Emilia-Romagna,44.49436681,11.3417208,99,10,109,962,1071,49,23415,4269,28755,317517
2840,7,8,ITA,6,Friuli Venezia Giulia,45.6494354,13.76813649,8,0,8,74,82,4,2904,345,3331,111069
2841,7,8,ITA,12,Lazio,41.89277044,12.48366722,198,13,211,663,874,14,6508,842,8224,293031
2842,7,8,ITA,7,Liguria,44.41149315,8.9326992,36,1,37,250,287,3,8161,1558,10006,84072
2843,7,8,ITA,3,Lombardia,45.46679409,9.190347404,211,34,245,8215,8460,71,69466,16725,94651,660133
2844,7,8,ITA,11,Marche,43.61675973,13.5188753,5,0,5,179,184,3,5623,987,6794,87842
2845,7,8,ITA,14,Molise,41.55774754,14.65916051,0,0,0,17,17,0,405,23,445,22851
2846,7,8,ITA,21,P.A. Bolzano,46.49933453,11.35662422,6,0,6,77,83,2,2275,292,2650,43534
2847,7,8,ITA,22,P.A. Trento,46.06893511,11.12123097,3,0,3,34,37,0,4434,405,4876,65705
2848,7,8,ITA,1,Piemonte,45.0732745,7.680687483,205,8,213,927,1140,25,26212,4107,31459,271685
2849,7,8,ITA,16,Puglia,41.12559576,16.86736689,14,0,14,64,78,1,3912,546,4536,130637
2850,7,8,ITA,20,Sardegna,39.21531192,9.110616306,3,0,3,7,10,0,1227,134,1371,75894
2851,7,8,ITA,19,Sicilia,38.11569725,13.3623567,7,0,7,120,127,1,2687,283,3097,184302
2852,7,8,ITA,9,Toscana,43.76923077,11.25588885,12,2,14,327,341,7,8854,1118,10313,242041
2853,7,8,ITA,10,Umbria,43.10675841,12.38824698,3,0,3,4,7,0,1360,80,1447,68863
2854,7,8,ITA,2,Valle d'Aosta,45.73750286,7.320149366,4,0,4,1,5,0,1045,146,1196,14235
2855,7,8,ITA,5,Veneto,45.43490485,12.33845213,17,3,20,366,386,7,16928,2034,19348,428743
2856,7,9,ITA,13,Abruzzo,42.35122196,13.39843823,26,0,26,121,147,8,2707,464,3318,74697
2857,7,9,ITA,17,Basilicata,40.63947052,15.80514834,2,0,2,3,5,0,373,27,405,40976
2858,7,9,ITA,18,Calabria,38.90597598,16.59440194,4,0,4,24,28,0,1060,97,1185,100551
2859,7,9,ITA,15,Campania,40.83956555,14.25084984,45,0,45,187,232,5,4091,432,4755,147644
2860,7,9,ITA,8,Emilia-Romagna,44.49436681,11.3417208,96,10,106,960,1066,29,23434,4269,28769,320516
2861,7,9,ITA,6,Friuli Venezia Giulia,45.6494354,13.76813649,2,0,2,73,75,1,2912,345,3332,111646
2862,7,9,ITA,12,Lazio,41.89277044,12.48366722,198,13,211,678,889,28,6520,843,8252,295193
2863,7,9,ITA,7,Liguria,44.41149315,8.9326992,34,1,35,243,278,4,8174,1558,10010,84825
2864,7,9,ITA,3,Lombardia,45.46679409,9.190347404,201,31,232,8125,8357,119,69683,16730,94770,667911
2865,7,9,ITA,11,Marche,43.61675973,13.5188753,5,0,5,168,173,4,5638,987,6798,88502
2866,7,9,ITA,14,Molise,41.55774754,14.65916051,0,0,0,15,15,0,407,23,445,23033
2867,7,9,ITA,21,P.A. Bolzano,46.49933453,11.35662422,6,0,6,78,84,3,2277,292,2653,43847
2868,7,9,ITA,22,P.A. Trento,46.06893511,11.12123097,1,0,1,32,33,0,4438,405,4876,66161
2869,7,9,ITA,1,Piemonte,45.0732745,7.680687483,193,10,203,921,1124,16,26243,4108,31475,273509
2870,7,9,ITA,16,Puglia,41.12559576,16.86736689,14,0,14,60,74,0,3916,546,4536,132160
2871,7,9,ITA,20,Sardegna,39.21531192,9.110616306,3,0,3,7,10,0,1227,134,1371,76752
2872,7,9,ITA,19,Sicilia,38.11569725,13.3623567,6,0,6,122,128,1,2687,283,3098,186170
2873,7,9,ITA,9,Toscana,43.76923077,11.25588885,11,2,13,324,337,1,8857,1120,10314,243990
2874,7,9,ITA,10,Umbria,43.10675841,12.38824698,3,0,3,4,7,0,1360,80,1447,69412
2875,7,9,ITA,2,Valle d'Aosta,45.73750286,7.320149366,4,0,4,1,5,0,1045,146,1196,14304
2876,7,9,ITA,5,Veneto,45.43490485,12.33845213,17,2,19,373,392,10,16929,2037,19358,431327
2877,7,10,ITA,13,Abruzzo,42.35122196,13.39843823,26,0,26,122,148,3,2709,464,3321,75231
2878,7,10,ITA,17,Basilicata,40.63947052,15.80514834,3,0,3,2,5,0,373,27,405,41193
2879,7,10,ITA,18,Calabria,38.90597598,16.59440194,4,0,4,23,27,1,1062,97,1186,101548
2880,7,10,ITA,15,Campania,40.83956555,14.25084984,44,0,44,193,237,7,4093,432,4762,148627
2881,7,10,ITA,8,Emilia-Romagna,44.49436681,11.3417208,96,10,106,1007,1113,53,23440,4269,28822,322910
2882,7,10,ITA,6,Friuli Venezia Giulia,45.6494354,13.76813649,2,0,2,76,78,1,2910,345,3333,112349
2883,7,10,ITA,12,Lazio,41.89277044,12.48366722,197,13,210,691,901,23,6530,844,8275,297217
2884,7,10,ITA,7,Liguria,44.41149315,8.9326992,25,1,26,238,264,15,8203,1558,10025,85633
2885,7,10,ITA,3,Lombardia,45.46679409,9.190347404,190,27,217,8124,8341,135,69828,16736,94905,675013
2886,7,10,ITA,11,Marche,43.61675973,13.5188753,4,0,4,164,168,1,5644,987,6799,88956
2887,7,10,ITA,14,Molise,41.55774754,14.65916051,0,0,0,15,15,0,407,23,445,23177
2888,7,10,ITA,21,P.A. Bolzano,46.49933453,11.35662422,6,0,6,80,86,5,2280,292,2658,44223
2889,7,10,ITA,22,P.A. Trento,46.06893511,11.12123097,1,0,1,26,27,3,4447,405,4879,66521
2890,7,10,ITA,1,Piemonte,45.0732745,7.680687483,193,9,202,873,1075,10,26300,4110,31485,275135
2891,7,10,ITA,16,Puglia,41.12559576,16.86736689,13,0,13,59,72,4,3922,546,4540,134139
2892,7,10,ITA,20,Sardegna,39.21531192,9.110616306,3,0,3,7,10,1,1228,134,1372,77452
2893,7,10,ITA,19,Sicilia,38.11569725,13.3623567,6,0,6,118,124,0,2691,283,3098,187482
2894,7,10,ITA,9,Toscana,43.76923077,11.25588885,9,2,11,319,330,2,8865,1121,10316,245794
2895,7,10,ITA,10,Umbria,43.10675841,12.38824698,4,0,4,4,8,1,1360,80,1448,69774
2896,7,10,ITA,2,Valle d'Aosta,45.73750286,7.320149366,4,0,4,1,5,0,1045,146,1196,14342
2897,7,10,ITA,5,Veneto,45.43490485,12.33845213,14,3,17,377,394,11,16936,2039,19369,433661
2898,7,11,ITA,13,Abruzzo,42.35122196,13.39843823,25,0,25,122,147,2,2712,464,3323,75741
2899,7,11,ITA,17,Basilicata,40.63947052,15.80514834,3,0,3,2,5,1,374,27,406,41474
2900,7,11,ITA,18,Calabria,38.90597598,16.59440194,4,0,4,25,29,2,1062,97,1188,102441
2901,7,11,ITA,15,Campania,40.83956555,14.25084984,47,0,47,195,242,7,4095,432,4769,149873
2902,7,11,ITA,8,Emilia-Romagna,44.49436681,11.3417208,93,10,103,1016,1119,47,23481,4269,28869,325438
2903,7,11,ITA,6,Friuli Venezia Giulia,45.6494354,13.76813649,1,0,1,78,79,2,2911,345,3335,112962
2904,7,11,ITA,12,Lazio,41.89277044,12.48366722,198,13,211,704,915,19,6535,844,8294,299223
2905,7,11,ITA,7,Liguria,44.41149315,8.9326992,26,0,26,227,253,6,8219,1559,10031,86422
2906,7,11,ITA,3,Lombardia,45.46679409,9.190347404,173,29,202,8010,8212,67,70020,16740,94972,679427
2907,7,11,ITA,11,Marche,43.61675973,13.5188753,4,0,4,165,169,4,5647,987,6803,89561
2908,7,11,ITA,14,Molise,41.55774754,14.65916051,0,0,0,12,12,0,410,23,445,23324
2909,7,11,ITA,21,P.A. Bolzano,46.49933453,11.35662422,6,0,6,76,82,3,2287,292,2661,44844
2910,7,11,ITA,22,P.A. Trento,46.06893511,11.12123097,2,0,2,26,28,2,4448,405,4881,66741
2911,7,11,ITA,1,Piemonte,45.0732745,7.680687483,190,9,199,870,1069,9,26314,4111,31494,276895
2912,7,11,ITA,16,Puglia,41.12559576,16.86736689,12,0,12,59,71,1,3924,546,4541,135169
2913,7,11,ITA,20,Sardegna,39.21531192,9.110616306,3,0,3,6,9,0,1229,134,1372,78149
2914,7,11,ITA,19,Sicilia,38.11569725,13.3623567,6,0,6,117,123,1,2693,283,3099,188817
2915,7,11,ITA,9,Toscana,43.76923077,11.25588885,7,3,10,320,330,5,8869,1122,10321,247347
2916,7,11,ITA,10,Umbria,43.10675841,12.38824698,4,0,4,4,8,0,1360,80,1448,70252
2917,7,11,ITA,2,Valle d'Aosta,45.73750286,7.320149366,2,0,2,1,3,0,1047,146,1196,14405
2918,7,11,ITA,5,Veneto,45.43490485,12.33845213,20,3,23,375,398,10,16942,2039,19379,437321
2919,7,12,ITA,13,Abruzzo,42.35122196,13.39843823,22,0,22,128,150,5,2713,465,3328,76203
2920,7,12,ITA,17,Basilicata,40.63947052,15.80514834,3,0,3,2,5,0,374,27,406,41474
2921,7,12,ITA,18,Calabria,38.90597598,16.59440194,4,0,4,53,57,28,1062,97,1216,103000
2922,7,12,ITA,15,Campania,40.83956555,14.25084984,13,0,13,233,246,3,4094,432,4772,150757
2923,7,12,ITA,8,Emilia-Romagna,44.49436681,11.3417208,93,10,103,1077,1180,71,23491,4269,28940,327651
2924,7,12,ITA,6,Friuli Venezia Giulia,45.6494354,13.76813649,2,0,2,77,79,0,2911,345,3335,113699
2925,7,12,ITA,12,Lazio,41.89277044,12.48366722,197,12,209,704,913,20,6557,844,8314,301453
2926,7,12,ITA,7,Liguria,44.41149315,8.9326992,25,0,25,214,239,0,8233,1559,10031,86925
2927,7,12,ITA,3,Lombardia,45.46679409,9.190347404,160,31,191,7813,8004,77,70297,16748,95049,685763
2928,7,12,ITA,11,Marche,43.61675973,13.5188753,4,0,4,163,167,1,5650,987,6804,90191
2929,7,12,ITA,14,Molise,41.55774754,14.65916051,1,0,1,12,13,1,410,23,446,23519
2930,7,12,ITA,21,P.A. Bolzano,46.49933453,11.35662422,6,0,6,82,88,5,2286,292,2666,45318
2931,7,12,ITA,22,P.A. Trento,46.06893511,11.12123097,2,0,2,24,26,0,4450,405,4881,67162
2932,7,12,ITA,1,Piemonte,45.0732745,7.680687483,190,9,199,859,1058,4,26329,4111,31498,278029
2933,7,12,ITA,16,Puglia,41.12559576,16.86736689,12,0,12,59,71,0,3924,546,4541,136109
2934,7,12,ITA,20,Sardegna,39.21531192,9.110616306,3,0,3,6,9,0,1229,134,1372,78515
2935,7,12,ITA,19,Sicilia,38.11569725,13.3623567,5,0,5,118,123,0,2693,283,3099,189943
2936,7,12,ITA,9,Toscana,43.76923077,11.25588885,8,3,11,320,331,1,8869,1122,10322,249202
2937,7,12,ITA,10,Umbria,43.10675841,12.38824698,4,0,4,5,9,2,1361,80,1450,70601
2938,7,12,ITA,2,Valle d'Aosta,45.73750286,7.320149366,2,0,2,1,3,0,1047,146,1196,14500
2939,7,12,ITA,5,Veneto,45.43490485,12.33845213,20,3,23,385,408,16,16948,2039,19395,438873
2940,7,13,ITA,13,Abruzzo,42.35122196,13.39843823,19,0,19,124,143,0,2719,466,3328,76243
2941,7,13,ITA,17,Basilicata,40.63947052,15.80514834,3,0,3,2,5,0,374,27,406,41783
2942,7,13,ITA,18,Calabria,38.90597598,16.59440194,4,0,4,53,57,0,1062,97,1216,103281
2943,7,13,ITA,15,Campania,40.83956555,14.25084984,16,0,16,237,253,7,4094,432,4779,151102
2944,7,13,ITA,8,Emilia-Romagna,44.49436681,11.3417208,93,9,102,1091,1193,18,23496,4269,28958,328603
2945,7,13,ITA,6,Friuli Venezia Giulia,45.6494354,13.76813649,3,0,3,77,80,0,2910,345,3335,113993
2946,7,13,ITA,12,Lazio,41.89277044,12.48366722,191,11,202,690,892,24,6601,845,8338,304024
2947,7,13,ITA,7,Liguria,44.41149315,8.9326992,24,0,24,194,218,1,8255,1559,10032,87165
2948,7,13,ITA,3,Lombardia,45.46679409,9.190347404,168,30,198,7813,8011,94,70375,16757,95143,689917
2949,7,13,ITA,11,Marche,43.61675973,13.5188753,4,0,4,155,159,0,5658,987,6804,90393
2950,7,13,ITA,14,Molise,41.55774754,14.65916051,1,0,1,12,13,0,410,23,446,23582
2951,7,13,ITA,21,P.A. Bolzano,46.49933453,11.35662422,6,0,6,89,95,7,2286,292,2673,45433
2952,7,13,ITA,22,P.A. Trento,46.06893511,11.12123097,2,0,2,24,26,0,4450,405,4881,67232
2953,7,13,ITA,1,Piemonte,45.0732745,7.680687483,180,9,189,864,1053,6,26339,4112,31504,278248
2954,7,13,ITA,16,Puglia,41.12559576,16.86736689,10,0,10,58,68,0,3926,547,4541,137079
2955,7,13,ITA,20,Sardegna,39.21531192,9.110616306,3,0,3,7,10,1,1229,134,1373,78923
2956,7,13,ITA,19,Sicilia,38.11569725,13.3623567,6,0,6,117,123,1,2694,283,3100,190293
2957,7,13,ITA,9,Toscana,43.76923077,11.25588885,7,3,10,325,335,4,8869,1122,10326,250093
2958,7,13,ITA,10,Umbria,43.10675841,12.38824698,4,0,4,4,8,0,1362,80,1450,70762
2959,7,13,ITA,2,Valle d'Aosta,45.73750286,7.320149366,2,0,2,1,3,0,1047,146,1196,14554
2960,7,13,ITA,5,Veneto,45.43490485,12.33845213,22,3,25,387,412,6,16950,2039,19401,440190
2961,7,14,ITA,13,Abruzzo,42.35122196,13.39843823,19,0,19,102,121,0,2740,467,3328,76420
2962,7,14,ITA,17,Basilicata,40.63947052,15.80514834,3,0,3,2,5,0,374,27,406,42071
2963,7,14,ITA,18,Calabria,38.90597598,16.59440194,5,0,5,52,57,0,1062,97,1216,104142
2964,7,14,ITA,15,Campania,40.83956555,14.25084984,16,1,17,235,252,0,4095,432,4779,151799
2965,7,14,ITA,8,Emilia-Romagna,44.49436681,11.3417208,93,9,102,1087,1189,13,23511,4271,28971,330870
2966,7,14,ITA,6,Friuli Venezia Giulia,45.6494354,13.76813649,4,0,4,82,86,3,2907,345,3338,114618
2967,7,14,ITA,12,Lazio,41.89277044,12.48366722,188,10,198,696,894,18,6616,846,8356,306387
2968,7,14,ITA,7,Liguria,44.41149315,8.9326992,23,0,23,171,194,6,8283,1561,10038,87873
2969,7,14,ITA,3,Lombardia,45.46679409,9.190347404,176,27,203,7749,7952,30,70461,16760,95173,693556
2970,7,14,ITA,11,Marche,43.61675973,13.5188753,4,0,4,156,160,1,5658,987,6805,90950
2971,7,14,ITA,14,Molise,41.55774754,14.65916051,1,0,1,8,9,0,414,23,446,23741
2972,7,14,ITA,21,P.A. Bolzano,46.49933453,11.35662422,6,0,6,89,95,1,2287,292,2674,46009
2973,7,14,ITA,22,P.A. Trento,46.06893511,11.12123097,2,0,2,24,26,0,4450,405,4881,67405
2974,7,14,ITA,1,Piemonte,45.0732745,7.680687483,175,9,184,730,914,3,26478,4115,31507,280065
2975,7,14,ITA,16,Puglia,41.12559576,16.86736689,10,0,10,58,68,0,3926,547,4541,138661
2976,7,14,ITA,20,Sardegna,39.21531192,9.110616306,4,0,4,6,10,1,1230,134,1374,79670
2977,7,14,ITA,19,Sicilia,38.11569725,13.3623567,4,0,4,133,137,15,2695,283,3115,192474
2978,7,14,ITA,9,Toscana,43.76923077,11.25588885,8,2,10,301,311,4,8894,1125,10330,251778
2979,7,14,ITA,10,Umbria,43.10675841,12.38824698,4,0,4,4,8,0,1362,80,1450,71359
2980,7,14,ITA,2,Valle d'Aosta,45.73750286,7.320149366,3,0,3,1,4,0,1046,146,1196,14621
2981,7,14,ITA,5,Veneto,45.43490485,12.33845213,29,2,31,396,427,19,16952,2041,19420,442646
2982,7,15,ITA,13,Abruzzo,42.35122196,13.39843823,17,0,17,107,124,3,2740,467,3331,76907
2983,7,15,ITA,17,Basilicata,40.63947052,15.80514834,3,0,3,2,5,0,373,27,405,42322
2984,7,15,ITA,18,Calabria,38.90597598,16.59440194,5,0,5,54,59,2,1062,97,1218,104921
2985,7,15,ITA,15,Campania,40.83956555,14.25084984,51,1,52,207,259,8,4096,432,4787,152896
2986,7,15,ITA,8,Emilia-Romagna,44.49436681,11.3417208,88,9,97,1073,1170,18,23548,4271,28989,333415
2987,7,15,ITA,6,Friuli Venezia Giulia,45.6494354,13.76813649,5,0,5,88,93,1,2901,345,3339,115345
2988,7,15,ITA,12,Lazio,41.89277044,12.48366722,190,10,200,698,898,20,6631,847,8376,308504
2989,7,15,ITA,7,Liguria,44.41149315,8.9326992,24,0,24,172,196,4,8285,1561,10042,88611
2990,7,15,ITA,3,Lombardia,45.46679409,9.190347404,177,23,200,7335,7535,63,70936,16765,95236,699935
2991,7,15,ITA,11,Marche,43.61675973,13.5188753,3,1,4,153,157,0,5661,987,6805,91580
2992,7,15,ITA,14,Molise,41.55774754,14.65916051,1,0,1,8,9,0,414,23,446,23903
2993,7,15,ITA,21,P.A. Bolzano,46.49933453,11.35662422,6,0,6,91,97,3,2288,292,2677,46587
2994,7,15,ITA,22,P.A. Trento,46.06893511,11.12123097,1,0,1,23,24,0,4452,405,4881,67776
2995,7,15,ITA,1,Piemonte,45.0732745,7.680687483,163,8,171,716,887,8,26510,4118,31515,281745
2996,7,15,ITA,16,Puglia,41.12559576,16.86736689,10,0,10,58,68,0,3926,547,4541,140603
2997,7,15,ITA,20,Sardegna,39.21531192,9.110616306,4,0,4,8,12,2,1230,134,1376,80552
2998,7,15,ITA,19,Sicilia,38.11569725,13.3623567,4,0,4,133,137,0,2695,283,3115,194142
2999,7,15,ITA,9,Toscana,43.76923077,11.25588885,9,3,12,301,313,8,8898,1127,10338,254060
3000,7,15,ITA,10,Umbria,43.10675841,12.38824698,5,0,5,5,10,2,1362,80,1452,71881
3001,7,15,ITA,2,Valle d'Aosta,45.73750286,7.320149366,1,0,1,1,2,0,1048,146,1196,14702
3002,7,15,ITA,5,Veneto,45.43490485,12.33845213,30,2,32,406,438,21,16960,2043,19441,445120
3003,7,16,ITA,13,Abruzzo,42.35122196,13.39843823,17,0,17,103,120,2,2745,468,3333,77425
3004,7,16,ITA,17,Basilicata,40.63947052,15.80514834,3,0,3,2,5,0,373,27,405,42615
3005,7,16,ITA,18,Calabria,38.90597598,16.59440194,5,0,5,60,65,8,1064,97,1226,105818
3006,7,16,ITA,15,Campania,40.83956555,14.25084984,23,1,24,238,262,4,4097,432,4791,153642
3007,7,16,ITA,8,Emilia-Romagna,44.49436681,11.3417208,88,9,97,1101,1198,46,23566,4271,29035,336154
3008,7,16,ITA,6,Friuli Venezia Giulia,45.6494354,13.76813649,7,0,7,90,97,4,2901,345,3343,116013
3009,7,16,ITA,12,Lazio,41.89277044,12.48366722,175,9,184,666,850,9,6687,848,8385,310829
3010,7,16,ITA,7,Liguria,44.41149315,8.9326992,28,0,28,173,201,8,8285,1564,10050,89337
3011,7,16,ITA,3,Lombardia,45.46679409,9.190347404,164,23,187,7322,7509,80,71032,16775,95316,706440
3012,7,16,ITA,11,Marche,43.61675973,13.5188753,3,1,4,152,156,1,5663,987,6806,92199
3013,7,16,ITA,14,Molise,41.55774754,14.65916051,1,0,1,8,9,0,414,23,446,24081
3014,7,16,ITA,21,P.A. Bolzano,46.49933453,11.35662422,6,0,6,94,100,1,2286,292,2678,47161
3015,7,16,ITA,22,P.A. Trento,46.06893511,11.12123097,1,0,1,17,18,0,4458,405,4881,68068
3016,7,16,ITA,1,Piemonte,45.0732745,7.680687483,159,6,165,703,868,7,26536,4118,31522,283577
3017,7,16,ITA,16,Puglia,41.12559576,16.86736689,11,0,11,57,68,1,3926,548,4542,142396
3018,7,16,ITA,20,Sardegna,39.21531192,9.110616306,4,0,4,7,11,1,1232,134,1377,81230
3019,7,16,ITA,19,Sicilia,38.11569725,13.3623567,6,0,6,148,154,17,2695,283,3132,195812
3020,7,16,ITA,9,Toscana,43.76923077,11.25588885,12,2,14,301,315,12,8908,1127,10350,255850
3021,7,16,ITA,10,Umbria,43.10675841,12.38824698,5,0,5,5,10,0,1362,80,1452,72335
3022,7,16,ITA,2,Valle d'Aosta,45.73750286,7.320149366,1,0,1,1,2,0,1048,146,1196,14736
3023,7,16,ITA,5,Veneto,45.43490485,12.33845213,31,2,33,422,455,29,16968,2047,19470,447878
3024,7,17,ITA,13,Abruzzo,42.35122196,13.39843823,17,0,17,102,119,1,2747,468,3334,77893
3025,7,17,ITA,17,Basilicata,40.63947052,15.80514834,3,0,3,2,5,0,373,27,405,42912
3026,7,17,ITA,18,Calabria,38.90597598,16.59440194,6,0,6,63,69,5,1065,97,1231,106677
3027,7,17,ITA,15,Campania,40.83956555,14.25084984,49,1,50,222,272,12,4098,433,4803,154665
3028,7,17,ITA,8,Emilia-Romagna,44.49436681,11.3417208,87,8,95,1133,1228,54,23586,4273,29087,339384
3029,7,17,ITA,6,Friuli Venezia Giulia,45.6494354,13.76813649,7,0,7,89,96,3,2905,345,3346,116622
3030,7,17,ITA,12,Lazio,41.89277044,12.48366722,175,9,184,668,852,14,6698,849,8399,313544
3031,7,17,ITA,7,Liguria,44.41149315,8.9326992,29,0,29,157,186,2,8301,1565,10052,90102
3032,7,17,ITA,3,Lombardia,45.46679409,9.190347404,159,22,181,7240,7421,55,71172,16778,95371,712261
3033,7,17,ITA,11,Marche,43.61675973,13.5188753,3,1,4,151,155,3,5667,987,6809,92653
3034,7,17,ITA,14,Molise,41.55774754,14.65916051,1,0,1,7,8,0,415,23,446,24242
3035,7,17,ITA,21,P.A. Bolzano,46.49933453,11.35662422,6,0,6,95,101,4,2289,292,2682,47745
3036,7,17,ITA,22,P.A. Trento,46.06893511,11.12123097,0,0,0,16,16,0,4460,405,4881,68352
3037,7,17,ITA,1,Piemonte,45.0732745,7.680687483,150,6,156,700,856,8,26555,4119,31530,285503
3038,7,17,ITA,16,Puglia,41.12559576,16.86736689,12,0,12,58,70,5,3929,548,4547,144093
3039,7,17,ITA,20,Sardegna,39.21531192,9.110616306,5,0,5,5,10,0,1233,134,1377,82095
3040,7,17,ITA,19,Sicilia,38.11569725,13.3623567,9,0,9,149,158,4,2695,283,3136,197335
3041,7,17,ITA,9,Toscana,43.76923077,11.25588885,12,1,13,305,318,6,8909,1129,10356,257616
3042,7,17,ITA,10,Umbria,43.10675841,12.38824698,6,0,6,6,12,2,1362,80,1454,72708
3043,7,17,ITA,2,Valle d'Aosta,45.73750286,7.320149366,2,0,2,0,2,0,1048,146,1196,14770
3044,7,17,ITA,5,Veneto,45.43490485,12.33845213,33,2,35,467,502,55,16976,2047,19525,451085
3045,7,18,ITA,13,Abruzzo,42.35122196,13.39843823,15,0,15,102,117,1,2750,468,3335,78469
3046,7,18,ITA,17,Basilicata,40.63947052,15.80514834,3,0,3,2,5,0,373,27,405,43235
3047,7,18,ITA,18,Calabria,38.90597598,16.59440194,5,0,5,70,75,7,1066,97,1238,107621
3048,7,18,ITA,15,Campania,40.83956555,14.25084984,44,1,45,242,287,15,4098,433,4818,155873
3049,7,18,ITA,8,Emilia-Romagna,44.49436681,11.3417208,85,8,93,1141,1234,40,23619,4274,29127,342592
3050,7,18,ITA,6,Friuli Venezia Giulia,45.6494354,13.76813649,7,0,7,92,99,4,2906,345,3350,117057
3051,7,18,ITA,12,Lazio,41.89277044,12.48366722,174,9,183,683,866,20,6703,850,8419,316173
3052,7,18,ITA,7,Liguria,44.41149315,8.9326992,28,0,28,172,200,18,8305,1565,10070,90954
3053,7,18,ITA,3,Lombardia,45.46679409,9.190347404,149,22,171,7084,7255,88,71416,16788,95459,717516
3054,7,18,ITA,11,Marche,43.61675973,13.5188753,2,1,3,152,155,3,5670,987,6812,93195
3055,7,18,ITA,14,Molise,41.55774754,14.65916051,1,0,1,7,8,0,415,23,446,24446
3056,7,18,ITA,21,P.A. Bolzano,46.49933453,11.35662422,6,0,6,95,101,1,2290,292,2683,48340
3057,7,18,ITA,22,P.A. Trento,46.06893511,11.12123097,0,0,0,19,19,3,4460,405,4884,68722
3058,7,18,ITA,1,Piemonte,45.0732745,7.680687483,150,6,156,691,847,3,26567,4119,31533,287012
3059,7,18,ITA,16,Puglia,41.12559576,16.86736689,14,0,14,58,72,3,3930,548,4550,145802
3060,7,18,ITA,20,Sardegna,39.21531192,9.110616306,7,0,7,4,11,1,1233,134,1378,82738
3061,7,18,ITA,19,Sicilia,38.11569725,13.3623567,14,0,14,148,162,4,2695,283,3140,198568
3062,7,18,ITA,9,Toscana,43.76923077,11.25588885,12,1,13,301,314,2,8915,1129,10358,259442
3063,7,18,ITA,10,Umbria,43.10675841,12.38824698,6,0,6,8,14,2,1362,80,1456,73180
3064,7,18,ITA,2,Valle d'Aosta,45.73750286,7.320149366,2,0,2,0,2,0,1048,146,1196,14826
3065,7,18,ITA,5,Veneto,45.43490485,12.33845213,33,2,35,490,525,34,16985,2049,19559,454065
3066,7,19,ITA,13,Abruzzo,42.35122196,13.39843823,14,0,14,103,117,1,2751,468,3336,78949
3067,7,19,ITA,17,Basilicata,40.63947052,15.80514834,2,0,2,5,7,3,373,28,408,43235
3068,7,19,ITA,18,Calabria,38.90597598,16.59440194,4,0,4,68,72,1,1070,97,1239,108451
3069,7,19,ITA,15,Campania,40.83956555,14.25084984,34,0,34,260,294,9,4100,433,4827,156869
3070,7,19,ITA,8,Emilia-Romagna,44.49436681,11.3417208,81,8,89,1177,1266,51,23638,4274,29178,344582
3071,7,19,ITA,6,Friuli Venezia Giulia,45.6494354,13.76813649,7,0,7,89,96,2,2911,345,3352,117551
3072,7,19,ITA,12,Lazio,41.89277044,12.48366722,180,9,189,683,872,17,6713,851,8436,318945
3073,7,19,ITA,7,Liguria,44.41149315,8.9326992,27,0,27,177,204,23,8324,1565,10093,91468
3074,7,19,ITA,3,Lombardia,45.46679409,9.190347404,148,22,170,7070,7240,33,71464,16788,95492,721640
3075,7,19,ITA,11,Marche,43.61675973,13.5188753,2,1,3,147,150,0,5674,987,6811,93692
3076,7,19,ITA,14,Molise,41.55774754,14.65916051,1,0,1,7,8,0,415,23,446,24537
3077,7,19,ITA,21,P.A. Bolzano,46.49933453,11.35662422,6,0,6,95,101,1,2291,292,2684,48617
3078,7,19,ITA,22,P.A. Trento,46.06893511,11.12123097,0,0,0,16,16,1,4464,405,4885,68907
3079,7,19,ITA,1,Piemonte,45.0732745,7.680687483,152,6,158,679,837,3,26580,4119,31536,288174
3080,7,19,ITA,16,Puglia,41.12559576,16.86736689,14,0,14,65,79,7,3930,548,4557,146774
3081,7,19,ITA,20,Sardegna,39.21531192,9.110616306,7,0,7,5,12,1,1233,134,1379,83144
3082,7,19,ITA,19,Sicilia,38.11569725,13.3623567,11,1,12,150,162,2,2697,283,3142,199333
3083,7,19,ITA,9,Toscana,43.76923077,11.25588885,12,0,12,313,325,16,8920,1129,10374,261174
3084,7,19,ITA,10,Umbria,43.10675841,12.38824698,6,0,6,6,12,0,1364,80,1456,73521
3085,7,19,ITA,2,Valle d'Aosta,45.73750286,7.320149366,2,0,2,1,3,0,1047,146,1196,14892
3086,7,19,ITA,5,Veneto,45.43490485,12.33845213,33,2,35,532,567,48,16990,2050,19607,455992
3087,7,20,ITA,13,Abruzzo,42.35122196,13.39843823,13,0,13,108,121,6,2753,468,3342,79070
3088,7,20,ITA,17,Basilicata,40.63947052,15.80514834,2,0,2,5,7,0,373,28,408,43486
3089,7,20,ITA,18,Calabria,38.90597598,16.59440194,3,0,3,68,71,0,1071,97,1239,108623
3090,7,20,ITA,15,Campania,40.83956555,14.25084984,32,0,32,264,296,6,4104,433,4833,157038
3091,7,20,ITA,8,Emilia-Romagna,44.49436681,11.3417208,91,6,97,1201,1298,42,23645,4277,29220,346535
3092,7,20,ITA,6,Friuli Venezia Giulia,45.6494354,13.76813649,7,0,7,92,99,4,2912,345,3356,118033
3093,7,20,ITA,12,Lazio,41.89277044,12.48366722,175,9,184,701,885,14,6714,851,8450,321110
3094,7,20,ITA,7,Liguria,44.41149315,8.9326992,28,0,28,157,185,12,8355,1565,10105,91898
3095,7,20,ITA,3,Lombardia,45.46679409,9.190347404,151,21,172,6969,7141,56,71611,16796,95548,724365
3096,7,20,ITA,11,Marche,43.61675973,13.5188753,2,1,3,143,146,0,5678,987,6811,93877
3097,7,20,ITA,14,Molise,41.55774754,14.65916051,1,0,1,7,8,0,415,23,446,24605
3098,7,20,ITA,21,P.A. Bolzano,46.49933453,11.35662422,6,0,6,94,100,0,2292,292,2684,48867
3099,7,20,ITA,22,P.A. Trento,46.06893511,11.12123097,1,0,1,19,20,4,4464,405,4889,69051
3100,7,20,ITA,1,Piemonte,45.0732745,7.680687483,150,6,156,677,833,1,26584,4120,31537,288837
3101,7,20,ITA,16,Puglia,41.12559576,16.86736689,14,0,14,65,79,0,3930,548,4557,147702
3102,7,20,ITA,20,Sardegna,39.21531192,9.110616306,7,0,7,5,12,0,1233,134,1379,83626
3103,7,20,ITA,19,Sicilia,38.11569725,13.3623567,10,2,12,145,157,2,2704,283,3144,200038
3104,7,20,ITA,9,Toscana,43.76923077,11.25588885,10,0,10,314,324,1,8921,1130,10375,261958
3105,7,20,ITA,10,Umbria,43.10675841,12.38824698,6,0,6,6,12,0,1364,80,1456,73653
3106,7,20,ITA,2,Valle d'Aosta,45.73750286,7.320149366,1,0,1,0,1,0,1049,146,1196,14947
3107,7,20,ITA,5,Veneto,45.43490485,12.33845213,35,2,37,572,609,42,16990,2050,19649,457249
3108,7,21,ITA,13,Abruzzo,42.35122196,13.39843823,12,0,12,104,116,2,2758,470,3344,79463
3109,7,21,ITA,17,Basilicata,40.63947052,15.80514834,2,0,2,5,7,0,373,28,408,43743
3110,7,21,ITA,18,Calabria,38.90597598,16.59440194,3,0,3,68,71,0,1071,97,1239,109566
3111,7,21,ITA,15,Campania,40.83956555,14.25084984,33,1,34,263,297,6,4108,434,4839,158142
3112,7,21,ITA,8,Emilia-Romagna,44.49436681,11.3417208,85,6,91,1206,1297,18,23662,4279,29238,349522
3113,7,21,ITA,6,Friuli Venezia Giulia,45.6494354,13.76813649,7,0,7,92,99,2,2914,345,3358,118838
3114,7,21,ITA,12,Lazio,41.89277044,12.48366722,175,9,184,697,881,6,6722,853,8456,322181
3115,7,21,ITA,7,Liguria,44.41149315,8.9326992,29,0,29,161,190,12,8362,1565,10117,92795
3116,7,21,ITA,3,Lombardia,45.46679409,9.190347404,151,21,172,6838,7010,34,71775,16797,95582,728169
3117,7,21,ITA,11,Marche,43.61675973,13.5188753,2,1,3,141,144,2,5682,987,6813,94527
3118,7,21,ITA,14,Molise,41.55774754,14.65916051,1,0,1,7,8,0,415,23,446,24768
3119,7,21,ITA,21,P.A. Bolzano,46.49933453,11.35662422,6,0,6,93,99,1,2294,292,2685,49079
3120,7,21,ITA,22,P.A. Trento,46.06893511,11.12123097,1,0,1,21,22,2,4464,405,4891,69272
3121,7,21,ITA,1,Piemonte,45.0732745,7.680687483,144,6,150,663,813,8,26609,4123,31545,290411
3122,7,21,ITA,16,Puglia,41.12559576,16.86736689,11,0,11,49,60,0,3948,548,4556,149713
3123,7,21,ITA,20,Sardegna,39.21531192,9.110616306,7,0,7,5,12,0,1233,134,1379,84157
3124,7,21,ITA,19,Sicilia,38.11569725,13.3623567,10,2,12,145,157,2,2706,283,3146,201700
3125,7,21,ITA,9,Toscana,43.76923077,11.25588885,11,1,12,314,326,9,8927,1131,10384,263474
3126,7,21,ITA,10,Umbria,43.10675841,12.38824698,6,0,6,8,14,3,1365,80,1459,74180
3127,7,21,ITA,2,Valle d'Aosta,45.73750286,7.320149366,1,0,1,0,1,0,1049,146,1196,15007
3128,7,21,ITA,5,Veneto,45.43490485,12.33845213,35,2,37,587,624,22,16994,2053,19671,459776
3129,7,22,ITA,13,Abruzzo,42.35122196,13.39843823,8,1,9,100,109,0,2763,470,3342,79901
3130,7,22,ITA,17,Basilicata,40.63947052,15.80514834,2,0,2,41,43,36,373,28,444,44008
3131,7,22,ITA,18,Calabria,38.90597598,16.59440194,3,0,3,72,75,4,1071,97,1243,110615
3132,7,22,ITA,15,Campania,40.83956555,14.25084984,29,1,30,285,315,19,4109,434,4858,159338
3133,7,22,ITA,8,Emilia-Romagna,44.49436681,11.3417208,81,7,88,1237,1325,57,23689,4281,29295,352794
3134,7,22,ITA,6,Friuli Venezia Giulia,45.6494354,13.76813649,8,0,8,90,98,2,2917,345,3360,119547
3135,7,22,ITA,12,Lazio,41.89277044,12.48366722,174,9,183,706,889,16,6728,855,8472,324963
3136,7,22,ITA,7,Liguria,44.41149315,8.9326992,31,0,31,164,195,7,8364,1565,10124,93807
3137,7,22,ITA,3,Lombardia,45.46679409,9.190347404,149,17,166,6809,6975,51,71860,16798,95633,733150
3138,7,22,ITA,11,Marche,43.61675973,13.5188753,2,1,3,137,140,1,5687,987,6814,95198
3139,7,22,ITA,14,Molise,41.55774754,14.65916051,1,0,1,10,11,4,416,23,450,24883
3140,7,22,ITA,21,P.A. Bolzano,46.49933453,11.35662422,6,0,6,90,96,0,2297,292,2685,49628
3141,7,22,ITA,22,P.A. Trento,46.06893511,11.12123097,2,0,2,39,41,20,4465,405,4911,69570
3142,7,22,ITA,1,Piemonte,45.0732745,7.680687483,146,6,152,637,789,13,26646,4123,31558,292191
3143,7,22,ITA,16,Puglia,41.12559576,16.86736689,11,0,11,45,56,0,3952,548,4556,151624
3144,7,22,ITA,20,Sardegna,39.21531192,9.110616306,7,0,7,5,12,1,1234,134,1380,84889
3145,7,22,ITA,19,Sicilia,38.11569725,13.3623567,10,3,13,148,161,7,2709,283,3153,203459
3146,7,22,ITA,9,Toscana,43.76923077,11.25588885,12,1,13,319,332,6,8927,1131,10390,266008
3147,7,22,ITA,10,Umbria,43.10675841,12.38824698,6,0,6,10,16,2,1365,80,1461,74634
3148,7,22,ITA,2,Valle d'Aosta,45.73750286,7.320149366,1,0,1,0,1,0,1049,146,1196,15112
3149,7,22,ITA,5,Veneto,45.43490485,12.33845213,35,2,37,606,643,36,17007,2057,19707,462452
3150,7,23,ITA,13,Abruzzo,42.35122196,13.39843823,8,2,10,105,115,10,2767,470,3352,80636
3151,7,23,ITA,17,Basilicata,40.63947052,15.80514834,2,0,2,44,46,3,373,28,447,44306
3152,7,23,ITA,18,Calabria,38.90597598,16.59440194,3,0,3,74,77,2,1071,97,1245,111757
3153,7,23,ITA,15,Campania,40.83956555,14.25084984,35,1,36,293,329,16,4111,434,4874,160605
3154,7,23,ITA,8,Emilia-Romagna,44.49436681,11.3417208,79,6,85,1265,1350,55,23719,4281,29350,357173
3155,7,23,ITA,6,Friuli Venezia Giulia,45.6494354,13.76813649,7,1,8,89,97,3,2921,345,3363,120339
3156,7,23,ITA,12,Lazio,41.89277044,12.48366722,180,9,189,718,907,26,6735,856,8498,327552
3157,7,23,ITA,7,Liguria,44.41149315,8.9326992,29,0,29,170,199,15,8374,1566,10139,94903
3158,7,23,ITA,3,Lombardia,45.46679409,9.190347404,139,17,156,6785,6941,82,71973,16801,95715,740405
3159,7,23,ITA,11,Marche,43.61675973,13.5188753,2,1,3,134,137,1,5691,987,6815,95858
3160,7,23,ITA,14,Molise,41.55774754,14.65916051,0,0,0,17,17,9,419,23,459,25185
3161,7,23,ITA,21,P.A. Bolzano,46.49933453,11.35662422,6,0,6,83,89,1,2305,292,2686,49882
3162,7,23,ITA,22,P.A. Trento,46.06893511,11.12123097,2,0,2,69,71,30,4465,405,4941,70026
3163,7,23,ITA,1,Piemonte,45.0732745,7.680687483,144,6,150,635,785,9,26659,4123,31567,294261
3164,7,23,ITA,16,Puglia,41.12559576,16.86736689,11,0,11,53,64,9,3953,548,4565,153199
3165,7,23,ITA,20,Sardegna,39.21531192,9.110616306,7,0,7,7,14,2,1234,134,1382,85852
3166,7,23,ITA,19,Sicilia,38.11569725,13.3623567,10,3,13,150,163,5,2712,283,3158,205508
3167,7,23,ITA,9,Toscana,43.76923077,11.25588885,14,1,15,313,328,4,8935,1131,10394,267719
3168,7,23,ITA,10,Umbria,43.10675841,12.38824698,6,0,6,11,17,2,1366,80,1463,75059
3169,7,23,ITA,2,Valle d'Aosta,45.73750286,7.320149366,1,0,1,0,1,0,1049,146,1196,15131
3170,7,23,ITA,5,Veneto,45.43490485,12.33845213,28,2,30,627,657,22,17010,2062,19729,465433
3171,7,24,ITA,13,Abruzzo,42.35122196,13.39843823,11,2,13,100,113,4,2773,470,3356,81191
3172,7,24,ITA,17,Basilicata,40.63947052,15.80514834,2,0,2,44,46,0,373,28,447,44561
3173,7,24,ITA,18,Calabria,38.90597598,16.59440194,3,0,3,75,78,1,1071,97,1246,112736
3174,7,24,ITA,15,Campania,40.83956555,14.25084984,17,2,19,313,332,6,4114,434,4880,162108
3175,7,24,ITA,8,Emilia-Romagna,44.49436681,11.3417208,79,4,83,1289,1372,63,23758,4283,29413,361148
3176,7,24,ITA,6,Friuli Venezia Giulia,45.6494354,13.76813649,9,2,11,87,98,5,2925,345,3368,121040
3177,7,24,ITA,12,Lazio,41.89277044,12.48366722,184,9,193,723,916,18,6743,857,8516,329353
3178,7,24,ITA,7,Liguria,44.41149315,8.9326992,26,0,26,172,198,5,8380,1566,10144,95636
3179,7,24,ITA,3,Lombardia,45.46679409,9.190347404,144,17,161,6598,6759,53,72208,16801,95768,746025
3180,7,24,ITA,11,Marche,43.61675973,13.5188753,2,1,3,129,132,1,5697,987,6816,96414
3181,7,24,ITA,14,Molise,41.55774754,14.65916051,0,0,0,18,18,1,419,23,460,25438
3182,7,24,ITA,21,P.A. Bolzano,46.49933453,11.35662422,6,0,6,77,83,1,2312,292,2687,50667
3183,7,24,ITA,22,P.A. Trento,46.06893511,11.12123097,2,0,2,85,87,16,4465,405,4957,70520
3184,7,24,ITA,1,Piemonte,45.0732745,7.680687483,147,5,152,624,776,11,26679,4123,31578,295873
3185,7,24,ITA,16,Puglia,41.12559576,16.86736689,11,0,11,56,67,13,3962,549,4578,155202
3186,7,24,ITA,20,Sardegna,39.21531192,9.110616306,7,0,7,9,16,3,1235,134,1385,86544
3187,7,24,ITA,19,Sicilia,38.11569725,13.3623567,11,2,13,157,170,8,2713,283,3166,206743
3188,7,24,ITA,9,Toscana,43.76923077,11.25588885,14,0,14,321,335,11,8939,1131,10405,269409
3189,7,24,ITA,10,Umbria,43.10675841,12.38824698,7,0,7,12,19,2,1366,80,1465,75407
3190,7,24,ITA,2,Valle d'Aosta,45.73750286,7.320149366,1,0,1,0,1,0,1049,146,1196,15168
3191,7,24,ITA,5,Veneto,45.43490485,12.33845213,30,2,32,653,685,30,17011,2063,19759,468576
3192,7,25,ITA,13,Abruzzo,42.35122196,13.39843823,11,2,13,99,112,3,2777,470,3359,81641
3193,7,25,ITA,17,Basilicata,40.63947052,15.80514834,2,0,2,44,46,1,374,28,448,44921
3194,7,25,ITA,18,Calabria,38.90597598,16.59440194,3,0,3,76,79,1,1071,97,1247,113685
3195,7,25,ITA,15,Campania,40.83956555,14.25084984,28,2,30,311,341,21,4126,434,4901,163877
3196,7,25,ITA,8,Emilia-Romagna,44.49436681,11.3417208,78,4,82,1317,1399,49,23778,4284,29461,364681
3197,7,25,ITA,6,Friuli Venezia Giulia,45.6494354,13.76813649,8,2,10,93,103,5,2925,345,3373,121861
3198,7,25,ITA,12,Lazio,41.89277044,12.48366722,186,9,195,733,928,19,6749,858,8535,331790
3199,7,25,ITA,7,Liguria,44.41149315,8.9326992,27,0,27,173,200,3,8381,1566,10147,96298
3200,7,25,ITA,3,Lombardia,45.46679409,9.190347404,148,13,161,6614,6775,79,72271,16801,95847,752200
3201,7,25,ITA,11,Marche,43.61675973,13.5188753,3,1,4,125,129,2,5702,987,6818,96918
3202,7,25,ITA,14,Molise,41.55774754,14.65916051,0,0,0,21,21,3,419,23,463,25598
3203,7,25,ITA,21,P.A. Bolzano,46.49933453,11.35662422,6,0,6,81,87,6,2314,292,2693,51322
3204,7,25,ITA,22,P.A. Trento,46.06893511,11.12123097,2,0,2,86,88,2,4466,405,4959,70932
3205,7,25,ITA,1,Piemonte,45.0732745,7.680687483,141,5,146,646,792,16,26677,4125,31594,297089
3206,7,25,ITA,16,Puglia,41.12559576,16.86736689,16,0,16,60,76,8,3961,549,4586,156395
3207,7,25,ITA,20,Sardegna,39.21531192,9.110616306,6,0,6,13,19,3,1235,134,1388,87120
3208,7,25,ITA,19,Sicilia,38.11569725,13.3623567,15,2,17,164,181,13,2715,283,3179,208167
3209,7,25,ITA,9,Toscana,43.76923077,11.25588885,13,0,13,330,343,10,8941,1131,10415,271049
3210,7,25,ITA,10,Umbria,43.10675841,12.38824698,7,0,7,10,17,0,1368,80,1465,75819
3211,7,25,ITA,2,Valle d'Aosta,45.73750286,7.320149366,1,0,1,0,1,0,1049,146,1196,15193
3212,7,25,ITA,5,Veneto,45.43490485,12.33845213,30,1,31,674,705,31,17021,2064,19790,471262
3213,7,26,ITA,13,Abruzzo,42.35122196,13.39843823,13,2,15,97,112,1,2777,470,3359,83616
3214,7,26,ITA,17,Basilicata,40.63947052,15.80514834,2,0,2,44,46,0,374,28,448,44921
3215,7,26,ITA,18,Calabria,38.90597598,16.59440194,3,0,3,76,79,0,1071,97,1247,114556
3216,7,26,ITA,15,Campania,40.83956555,14.25084984,28,4,32,320,352,11,4126,434,4912,165489
3217,7,26,ITA,8,Emilia-Romagna,44.49436681,11.3417208,75,4,79,1365,1444,61,23793,4285,29522,367597
3218,7,26,ITA,6,Friuli Venezia Giulia,45.6494354,13.76813649,9,2,11,94,105,2,2925,345,3375,122167
3219,7,26,ITA,12,Lazio,41.89277044,12.48366722,189,9,198,737,935,19,6759,860,8554,334242
3220,7,26,ITA,7,Liguria,44.41149315,8.9326992,29,1,30,173,203,3,8381,1566,10150,96890
3221,7,26,ITA,3,Lombardia,45.46679409,9.190347404,139,13,152,6619,6771,74,72349,16801,95921,756888
3222,7,26,ITA,11,Marche,43.61675973,13.5188753,3,1,4,118,122,7,5716,987,6825,97446
3223,7,26,ITA,14,Molise,41.55774754,14.65916051,1,0,1,21,22,3,421,23,466,25741
3224,7,26,ITA,21,P.A. Bolzano,46.49933453,11.35662422,7,0,7,85,92,5,2314,292,2698,51844
3225,7,26,ITA,22,P.A. Trento,46.06893511,11.12123097,1,0,1,92,93,6,4467,405,4965,71268
3226,7,26,ITA,1,Piemonte,45.0732745,7.680687483,143,5,148,654,802,12,26678,4126,31606,298776
3227,7,26,ITA,16,Puglia,41.12559576,16.86736689,15,0,15,63,78,3,3961,550,4589,157669
3228,7,26,ITA,20,Sardegna,39.21531192,9.110616306,6,0,6,13,19,0,1235,134,1388,87413
3229,7,26,ITA,19,Sicilia,38.11569725,13.3623567,20,2,22,173,195,14,2715,283,3193,209196
3230,7,26,ITA,9,Toscana,43.76923077,11.25588885,13,0,13,342,355,15,8944,1131,10430,272875
3231,7,26,ITA,10,Umbria,43.10675841,12.38824698,7,0,7,10,17,0,1368,80,1465,76185
3232,7,26,ITA,2,Valle d'Aosta,45.73750286,7.320149366,1,0,1,0,1,0,1049,146,1196,15254
3233,7,26,ITA,5,Veneto,45.43490485,12.33845213,31,1,32,690,722,19,17023,2064,19809,472962
3234,7,27,ITA,13,Abruzzo,42.35122196,13.39843823,13,1,14,100,114,9,2783,471,3368,82423
3235,7,27,ITA,17,Basilicata,40.63947052,15.80514834,2,0,2,45,47,1,374,28,449,45189
3236,7,27,ITA,18,Calabria,38.90597598,16.59440194,3,0,3,75,78,0,1072,97,1247,114756
3237,7,27,ITA,15,Campania,40.83956555,14.25084984,29,4,33,332,365,14,4127,434,4926,165961
3238,7,27,ITA,8,Emilia-Romagna,44.49436681,11.3417208,77,4,81,1375,1456,33,23814,4285,29555,375850
3239,7,27,ITA,6,Friuli Venezia Giulia,45.6494354,13.76813649,8,2,10,102,112,0,2918,345,3375,122564
3240,7,27,ITA,12,Lazio,41.89277044,12.48366722,193,9,202,742,944,13,6762,861,8567,336276
3241,7,27,ITA,7,Liguria,44.41149315,8.9326992,29,1,30,180,210,24,8398,1566,10174,97867
3242,7,27,ITA,3,Lombardia,45.46679409,9.190347404,137,14,151,6574,6725,34,72429,16801,95955,759439
3243,7,27,ITA,11,Marche,43.61675973,13.5188753,5,0,5,107,112,2,5728,987,6827,97635
3244,7,27,ITA,14,Molise,41.55774754,14.65916051,1,0,1,24,25,3,421,23,469,25868
3245,7,27,ITA,21,P.A. Bolzano,46.49933453,11.35662422,7,0,7,87,94,2,2314,292,2700,52154
3246,7,27,ITA,22,P.A. Trento,46.06893511,11.12123097,1,0,1,93,94,1,4467,405,4966,71334
3247,7,27,ITA,1,Piemonte,45.0732745,7.680687483,141,5,146,656,802,4,26681,4127,31610,299026
3248,7,27,ITA,16,Puglia,41.12559576,16.86736689,15,0,15,64,79,3,3962,551,4592,158704
3249,7,27,ITA,20,Sardegna,39.21531192,9.110616306,5,0,5,10,15,0,1236,135,1386,87773
3250,7,27,ITA,19,Sicilia,38.11569725,13.3623567,22,4,26,168,194,3,2719,283,3196,210021
3251,7,27,ITA,9,Toscana,43.76923077,11.25588885,13,0,13,350,363,8,8944,1131,10438,273792
3252,7,27,ITA,10,Umbria,43.10675841,12.38824698,7,1,8,9,17,0,1368,80,1465,76311
3253,7,27,ITA,2,Valle d'Aosta,45.73750286,7.320149366,1,0,1,0,1,0,1049,146,1196,15320
3254,7,27,ITA,5,Veneto,45.43490485,12.33845213,31,0,31,703,734,16,17027,2064,19825,474106
3255,7,28,ITA,13,Abruzzo,42.35122196,13.39843823,14,1,15,92,107,1,2790,472,3369,82644
3256,7,28,ITA,17,Basilicata,40.63947052,15.80514834,2,0,2,45,47,0,374,28,449,45492
3257,7,28,ITA,18,Calabria,38.90597598,16.59440194,3,0,3,80,83,5,1072,97,1252,115672
3258,7,28,ITA,15,Campania,40.83956555,14.25084984,27,4,31,362,393,29,4128,434,4955,167057
3259,7,28,ITA,8,Emilia-Romagna,44.49436681,11.3417208,72,3,75,1384,1459,20,23830,4286,29575,379540
3260,7,28,ITA,6,Friuli Venezia Giulia,45.6494354,13.76813649,7,2,9,103,112,0,2918,345,3375,123405
3261,7,28,ITA,12,Lazio,41.89277044,12.48366722,194,9,203,739,942,10,6773,862,8577,337657
3262,7,28,ITA,7,Liguria,44.41149315,8.9326992,27,0,27,182,209,3,8402,1566,10177,98525
3263,7,28,ITA,3,Lombardia,45.46679409,9.190347404,151,13,164,6514,6678,53,72528,16802,96008,763406
3264,7,28,ITA,11,Marche,43.61675973,13.5188753,4,0,4,116,120,11,5731,987,6838,98242
3265,7,28,ITA,14,Molise,41.55774754,14.65916051,1,0,1,24,25,0,421,23,469,26017
3266,7,28,ITA,21,P.A. Bolzano,46.49933453,11.35662422,7,0,7,78,85,2,2315,292,2692,52364
3267,7,28,ITA,22,P.A. Trento,46.06893511,11.12123097,1,0,1,93,94,0,4467,405,4966,71558
3268,7,28,ITA,1,Piemonte,45.0732745,7.680687483,136,5,141,660,801,12,26694,4127,31622,300716
3269,7,28,ITA,16,Puglia,41.12559576,16.86736689,15,0,15,67,82,4,3963,551,4596,160386
3270,7,28,ITA,20,Sardegna,39.21531192,9.110616306,5,0,5,16,21,6,1237,134,1392,88391
3271,7,28,ITA,19,Sicilia,38.11569725,13.3623567,29,2,31,175,206,19,2726,283,3215,211860
3272,7,28,ITA,9,Toscana,43.76923077,11.25588885,13,0,13,350,363,3,8944,1134,10441,275553
3273,7,28,ITA,10,Umbria,43.10675841,12.38824698,7,1,8,9,17,0,1368,80,1465,76851
3274,7,28,ITA,2,Valle d'Aosta,45.73750286,7.320149366,1,0,1,10,11,10,1049,146,1206,15399
3275,7,28,ITA,5,Veneto,45.43490485,12.33845213,33,0,33,721,754,24,17026,2069,19849,476975
3276,7,29,ITA,13,Abruzzo,42.35122196,13.39843823,14,1,15,94,109,4,2792,472,3373,83195
3277,7,29,ITA,17,Basilicata,40.63947052,15.80514834,2,0,2,45,47,0,374,28,449,45750
3278,7,29,ITA,18,Calabria,38.90597598,16.59440194,3,0,3,83,86,3,1072,97,1255,116558
3279,7,29,ITA,15,Campania,40.83956555,14.25084984,26,1,27,381,408,19,4132,434,4974,168298
3280,7,29,ITA,8,Emilia-Romagna,44.49436681,11.3417208,66,3,69,1382,1451,28,23865,4287,29603,384747
3281,7,29,ITA,6,Friuli Venezia Giulia,45.6494354,13.76813649,8,2,10,102,112,3,2921,345,3378,124140
3282,7,29,ITA,12,Lazio,41.89277044,12.48366722,198,9,207,762,969,34,6780,862,8611,339954
3283,7,29,ITA,7,Liguria,44.41149315,8.9326992,21,0,21,176,197,20,8434,1566,10197,99364
3284,7,29,ITA,3,Lombardia,45.46679409,9.190347404,154,13,167,6396,6563,46,72689,16802,96054,768509
3285,7,29,ITA,11,Marche,43.61675973,13.5188753,5,0,5,125,130,17,5738,987,6855,98940
3286,7,29,ITA,14,Molise,41.55774754,14.65916051,1,0,1,25,26,1,421,23,470,26232
3287,7,29,ITA,21,P.A. Bolzano,46.49933453,11.35662422,6,1,7,79,86,5,2318,292,2696,52913
3288,7,29,ITA,22,P.A. Trento,46.06893511,11.12123097,0,0,0,98,98,4,4467,405,4970,71918
3289,7,29,ITA,1,Piemonte,45.0732745,7.680687483,124,5,129,672,801,14,26707,4128,31636,302380
3290,7,29,ITA,16,Puglia,41.12559576,16.86736689,17,0,17,75,92,10,3963,551,4606,162238
3291,7,29,ITA,20,Sardegna,39.21531192,9.110616306,3,0,3,20,23,2,1237,134,1394,89000
3292,7,29,ITA,19,Sicilia,38.11569725,13.3623567,29,2,31,193,224,18,2726,283,3233,213928
3293,7,29,ITA,9,Toscana,43.76923077,11.25588885,15,0,15,365,380,17,8944,1134,10458,277889
3294,7,29,ITA,10,Umbria,43.10675841,12.38824698,7,1,8,9,17,0,1368,80,1465,77327
3295,7,29,ITA,2,Valle d'Aosta,45.73750286,7.320149366,1,0,1,12,13,2,1049,146,1208,15465
3296,7,29,ITA,5,Veneto,45.43490485,12.33845213,31,0,31,753,784,42,17034,2073,19891,479840
3297,7,30,ITA,13,Abruzzo,42.35122196,13.39843823,14,1,15,91,106,4,2799,472,3377,83816
3298,7,30,ITA,17,Basilicata,40.63947052,15.80514834,2,0,2,45,47,0,374,28,449,46028
3299,7,30,ITA,18,Calabria,38.90597598,16.59440194,3,1,4,89,93,7,1072,97,1262,117676
3300,7,30,ITA,15,Campania,40.83956555,14.25084984,49,6,55,344,399,16,4157,434,4990,169546
3301,7,30,ITA,8,Emilia-Romagna,44.49436681,11.3417208,65,4,69,1402,1471,35,23874,4289,29634,390738
3302,7,30,ITA,6,Friuli Venezia Giulia,45.6494354,13.76813649,9,2,11,111,122,13,2924,345,3391,124938
3303,7,30,ITA,12,Lazio,41.89277044,12.48366722,188,9,197,740,937,18,6829,863,8629,341764
3304,7,30,ITA,7,Liguria,44.41149315,8.9326992,21,0,21,175,196,13,8448,1566,10210,100167
3305,7,30,ITA,3,Lombardia,45.46679409,9.190347404,151,13,164,5871,6035,88,73305,16802,96142,775765
3306,7,30,ITA,11,Marche,43.61675973,13.5188753,6,0,6,124,130,8,5746,987,6863,99696
3307,7,30,ITA,14,Molise,41.55774754,14.65916051,1,0,1,25,26,0,421,23,470,26384
3308,7,30,ITA,21,P.A. Bolzano,46.49933453,11.35662422,6,1,7,85,92,6,2318,292,2702,53491
3309,7,30,ITA,22,P.A. Trento,46.06893511,11.12123097,0,0,0,101,101,3,4467,405,4973,72141
3310,7,30,ITA,1,Piemonte,45.0732745,7.680687483,124,5,129,661,790,10,26728,4128,31646,304335
3311,7,30,ITA,16,Puglia,41.12559576,16.86736689,17,0,17,77,94,3,3964,551,4609,163824
3312,7,30,ITA,20,Sardegna,39.21531192,9.110616306,3,0,3,20,23,0,1237,134,1394,89608
3313,7,30,ITA,19,Sicilia,38.11569725,13.3623567,33,2,35,224,259,39,2730,283,3272,216010
3314,7,30,ITA,9,Toscana,43.76923077,11.25588885,17,0,17,372,389,11,8946,1134,10469,279879
3315,7,30,ITA,10,Umbria,43.10675841,12.38824698,7,0,7,10,17,0,1368,80,1465,77819
3316,7,30,ITA,2,Valle d'Aosta,45.73750286,7.320149366,1,0,1,11,12,0,1050,146,1208,15516
3317,7,30,ITA,5,Veneto,45.43490485,12.33845213,31,3,34,857,891,112,17039,2073,20003,482840
3318,7,31,ITA,13,Abruzzo,42.35122196,13.39843823,13,1,14,97,111,5,2799,472,3382,84411
3319,7,31,ITA,17,Basilicata,40.63947052,15.80514834,2,0,2,48,50,3,374,28,452,46410
3320,7,31,ITA,18,Calabria,38.90597598,16.59440194,3,1,4,93,97,4,1072,97,1266,118634
3321,7,31,ITA,15,Campania,40.83956555,14.25084984,48,6,54,341,395,9,4169,435,4999,170810
3322,7,31,ITA,8,Emilia-Romagna,44.49436681,11.3417208,59,4,63,1433,1496,36,23885,4289,29670,395936
3323,7,31,ITA,6,Friuli Venezia Giulia,45.6494354,13.76813649,9,2,11,111,122,3,2927,345,3394,125634
3324,7,31,ITA,12,Lazio,41.89277044,12.48366722,183,9,192,753,945,18,6839,863,8647,343670
3325,7,31,ITA,7,Liguria,44.41149315,8.9326992,19,0,19,181,200,4,8447,1567,10214,100861
3326,7,31,ITA,3,Lombardia,45.46679409,9.190347404,148,7,155,5856,6011,77,73402,16806,96219,782147
3327,7,31,ITA,11,Marche,43.61675973,13.5188753,6,0,6,141,147,21,5750,987,6884,100200
3328,7,31,ITA,14,Molise,41.55774754,14.65916051,1,0,1,26,27,1,421,23,471,26528
3329,7,31,ITA,21,P.A. Bolzano,46.49933453,11.35662422,6,1,7,95,102,15,2323,292,2717,54206
3330,7,31,ITA,22,P.A. Trento,46.06893511,11.12123097,0,0,0,100,100,2,4470,405,4975,72464
3331,7,31,ITA,1,Piemonte,45.0732745,7.680687483,103,5,108,691,799,21,26739,4129,31667,305619
3332,7,31,ITA,16,Puglia,41.12559576,16.86736689,18,0,18,77,95,2,3964,552,4611,165237
3333,7,31,ITA,20,Sardegna,39.21531192,9.110616306,3,0,3,30,33,10,1237,134,1404,90445
3334,7,31,ITA,19,Sicilia,38.11569725,13.3623567,38,2,40,235,275,16,2730,283,3288,217405
3335,7,31,ITA,9,Toscana,43.76923077,11.25588885,17,0,17,370,387,14,8962,1134,10483,281692
3336,7,31,ITA,10,Umbria,43.10675841,12.38824698,6,0,6,12,18,1,1368,80,1466,78170
3337,7,31,ITA,2,Valle d'Aosta,45.73750286,7.320149366,1,0,1,11,12,0,1050,146,1208,15574
3338,7,31,ITA,5,Veneto,45.43490485,12.33845213,33,3,36,964,1000,117,17046,2074,20120,485614
3339,8,1,ITA,13,Abruzzo,42.35122196,13.39843823,13,1,14,101,115,5,2800,472,3387,85021
3340,8,1,ITA,17,Basilicata,40.63947052,15.80514834,2,0,2,48,50,0,374,28,452,46639
3341,8,1,ITA,18,Calabria,38.90597598,16.59440194,4,1,5,92,97,3,1075,97,1269,119769
3342,8,1,ITA,15,Campania,40.83956555,14.25084984,39,3,42,355,397,10,4177,435,5009,172579
3343,8,1,ITA,8,Emilia-Romagna,44.49436681,11.3417208,67,4,71,1439,1510,56,23925,4291,29726,402424
3344,8,1,ITA,6,Friuli Venezia Giulia,45.6494354,13.76813649,8,3,11,118,129,7,2927,345,3401,126425
3345,8,1,ITA,12,Lazio,41.89277044,12.48366722,172,9,181,769,950,18,6852,863,8665,345548
3346,8,1,ITA,7,Liguria,44.41149315,8.9326992,19,0,19,194,213,16,8450,1567,10230,101716
3347,8,1,ITA,3,Lombardia,45.46679409,9.190347404,158,9,167,5788,5955,55,73512,16807,96274,787173
3348,8,1,ITA,11,Marche,43.61675973,13.5188753,8,0,8,136,144,5,5758,987,6889,100767
3349,8,1,ITA,14,Molise,41.55774754,14.65916051,1,0,1,28,29,2,421,23,473,26698
3350,8,1,ITA,21,P.A. Bolzano,46.49933453,11.35662422,6,1,7,100,107,8,2326,292,2725,54755
3351,8,1,ITA,22,P.A. Trento,46.06893511,11.12123097,1,0,1,98,99,0,4471,405,4975,72811
3352,8,1,ITA,1,Piemonte,45.0732745,7.680687483,96,5,101,700,801,16,26753,4129,31683,307168
3353,8,1,ITA,16,Puglia,41.12559576,16.86736689,19,0,19,93,112,20,3967,552,4631,166712
3354,8,1,ITA,20,Sardegna,39.21531192,9.110616306,4,0,4,35,39,6,1237,134,1410,91026
3355,8,1,ITA,19,Sicilia,38.11569725,13.3623567,36,3,39,242,281,10,2734,283,3298,219093
3356,8,1,ITA,9,Toscana,43.76923077,11.25588885,16,0,16,376,392,6,8962,1135,10489,283394
3357,8,1,ITA,10,Umbria,43.10675841,12.38824698,7,0,7,17,24,6,1368,80,1472,78643
3358,8,1,ITA,2,Valle d'Aosta,45.73750286,7.320149366,1,0,1,11,12,0,1050,146,1208,15609
3359,8,1,ITA,5,Veneto,45.43490485,12.33845213,28,4,32,969,1001,46,17090,2075,20166,489602
3360,8,2,ITA,13,Abruzzo,42.35122196,13.39843823,16,1,17,99,116,2,2801,472,3389,85639
3361,8,2,ITA,17,Basilicata,40.63947052,15.80514834,2,0,2,49,51,1,374,28,453,46640
3362,8,2,ITA,18,Calabria,38.90597598,16.59440194,5,1,6,92,98,1,1075,97,1270,120328
3363,8,2,ITA,15,Campania,40.83956555,14.25084984,35,3,38,363,401,7,4180,435,5016,174273
3364,8,2,ITA,8,Emilia-Romagna,44.49436681,11.3417208,68,4,72,1468,1540,49,23943,4291,29774,407452
3365,8,2,ITA,6,Friuli Venezia Giulia,45.6494354,13.76813649,9,3,12,125,137,10,2929,345,3411,126943
3366,8,2,ITA,12,Lazio,41.89277044,12.48366722,176,9,185,779,964,17,6855,863,8682,347749
3367,8,2,ITA,7,Liguria,44.41149315,8.9326992,20,0,20,196,216,6,8453,1567,10236,102520
3368,8,2,ITA,3,Lombardia,45.46679409,9.190347404,153,9,162,5659,5821,38,73676,16815,96312,791698
3369,8,2,ITA,11,Marche,43.61675973,13.5188753,11,0,11,136,147,8,5763,987,6897,101330
3370,8,2,ITA,14,Molise,41.55774754,14.65916051,1,0,1,30,31,2,421,23,475,26987
3371,8,2,ITA,21,P.A. Bolzano,46.49933453,11.35662422,7,0,7,100,107,3,2329,292,2728,55385
3372,8,2,ITA,22,P.A. Trento,46.06893511,11.12123097,1,0,1,98,99,4,4475,405,4979,73042
3373,8,2,ITA,1,Piemonte,45.0732745,7.680687483,95,5,100,710,810,15,26759,4129,31698,308574
3374,8,2,ITA,16,Puglia,41.12559576,16.86736689,20,0,20,100,120,8,3967,552,4639,167514
3375,8,2,ITA,20,Sardegna,39.21531192,9.110616306,3,0,3,40,43,4,1237,134,1414,91373
3376,8,2,ITA,19,Sicilia,38.11569725,13.3623567,36,3,39,246,285,7,2737,283,3305,220126
3377,8,2,ITA,9,Toscana,43.76923077,11.25588885,15,0,15,382,397,9,8966,1135,10498,285083
3378,8,2,ITA,10,Umbria,43.10675841,12.38824698,7,0,7,19,26,2,1368,80,1474,78969
3379,8,2,ITA,2,Valle d'Aosta,45.73750286,7.320149366,1,0,1,12,13,1,1050,146,1209,15680
3380,8,2,ITA,5,Veneto,45.43490485,12.33845213,27,4,31,1003,1034,45,17102,2075,20211,490763
3381,8,3,ITA,13,Abruzzo,42.35122196,13.39843823,16,1,17,107,124,9,2802,472,3398,85744
3382,8,3,ITA,17,Basilicata,40.63947052,15.80514834,2,0,2,49,51,0,374,28,453,46916
3383,8,3,ITA,18,Calabria,38.90597598,16.59440194,5,1,6,92,98,0,1075,97,1270,120567
3384,8,3,ITA,15,Campania,40.83956555,14.25084984,47,2,49,348,397,4,4187,436,5020,174985
3385,8,3,ITA,8,Emilia-Romagna,44.49436681,11.3417208,68,3,71,1489,1560,34,23957,4291,29808,409341
3386,8,3,ITA,6,Friuli Venezia Giulia,45.6494354,13.76813649,9,3,12,124,136,0,2929,346,3411,127228
3387,8,3,ITA,12,Lazio,41.89277044,12.48366722,174,9,183,791,974,15,6859,864,8697,349522
3388,8,3,ITA,7,Liguria,44.41149315,8.9326992,21,0,21,174,195,2,8475,1568,10238,102878
3389,8,3,ITA,3,Lombardia,45.46679409,9.190347404,162,9,171,5624,5795,25,73724,16818,96337,794279
3390,8,3,ITA,11,Marche,43.61675973,13.5188753,13,0,13,127,140,0,5770,987,6897,101386
3391,8,3,ITA,14,Molise,41.55774754,14.65916051,1,0,1,32,33,2,421,23,477,27070
3392,8,3,ITA,21,P.A. Bolzano,46.49933453,11.35662422,7,0,7,105,112,6,2330,292,2734,55757
3393,8,3,ITA,22,P.A. Trento,46.06893511,11.12123097,3,0,3,97,100,2,4476,405,4981,73149
3394,8,3,ITA,1,Piemonte,45.0732745,7.680687483,95,5,100,713,813,13,26767,4131,31711,309217
3395,8,3,ITA,16,Puglia,41.12559576,16.86736689,23,0,23,102,125,9,3970,553,4648,168787
3396,8,3,ITA,20,Sardegna,39.21531192,9.110616306,3,0,3,41,44,2,1238,134,1416,91739
3397,8,3,ITA,19,Sicilia,38.11569725,13.3623567,36,3,39,249,288,3,2737,283,3308,220629
3398,8,3,ITA,9,Toscana,43.76923077,11.25588885,16,1,17,381,398,10,8974,1136,10508,285916
3399,8,3,ITA,10,Umbria,43.10675841,12.38824698,7,0,7,20,27,1,1368,80,1475,79126
3400,8,3,ITA,2,Valle d'Aosta,45.73750286,7.320149366,1,0,1,12,13,0,1050,146,1209,15732
3401,8,3,ITA,5,Veneto,45.43490485,12.33845213,25,4,29,1022,1051,22,17106,2076,20233,491567
3402,8,4,ITA,13,Abruzzo,42.35122196,13.39843823,18,1,19,106,125,3,2804,472,3401,86079
3403,8,4,ITA,17,Basilicata,40.63947052,15.80514834,2,0,2,49,51,0,374,28,453,47142
3404,8,4,ITA,18,Calabria,38.90597598,16.59440194,6,1,7,92,99,2,1076,97,1272,121434
3405,8,4,ITA,15,Campania,40.83956555,14.25084984,44,2,46,346,392,2,4194,436,5022,175739
3406,8,4,ITA,8,Emilia-Romagna,44.49436681,11.3417208,79,4,83,1498,1581,42,23978,4291,29850,412865
3407,8,4,ITA,6,Friuli Venezia Giulia,45.6494354,13.76813649,7,2,9,129,138,5,2932,346,3416,127931
3408,8,4,ITA,12,Lazio,41.89277044,12.48366722,179,8,187,800,987,17,6863,864,8714,351191
3409,8,4,ITA,7,Liguria,44.41149315,8.9326992,22,0,22,178,200,5,8475,1568,10243,103441
3410,8,4,ITA,3,Lombardia,45.46679409,9.190347404,160,9,169,5583,5752,44,73810,16819,96381,797918
3411,8,4,ITA,11,Marche,43.61675973,13.5188753,15,0,15,124,139,2,5773,987,6899,101871
3412,8,4,ITA,14,Molise,41.55774754,14.65916051,1,0,1,32,33,0,421,23,477,27197
3413,8,4,ITA,21,P.A. Bolzano,46.49933453,11.35662422,7,0,7,111,118,6,2330,292,2740,56024
3414,8,4,ITA,22,P.A. Trento,46.06893511,11.12123097,3,0,3,85,88,2,4490,405,4983,73352
3415,8,4,ITA,1,Piemonte,45.0732745,7.680687483,101,6,107,691,798,8,26789,4132,31719,310492
3416,8,4,ITA,16,Puglia,41.12559576,16.86736689,22,0,22,109,131,7,3971,553,4655,170642
3417,8,4,ITA,20,Sardegna,39.21531192,9.110616306,3,0,3,42,45,2,1239,134,1418,92306
3418,8,4,ITA,19,Sicilia,38.11569725,13.3623567,34,3,37,256,293,10,2741,284,3318,222225
3419,8,4,ITA,9,Toscana,43.76923077,11.25588885,18,0,18,387,405,11,8977,1137,10519,287473
3420,8,4,ITA,10,Umbria,43.10675841,12.38824698,7,0,7,22,29,2,1368,80,1477,79586
3421,8,4,ITA,2,Valle d'Aosta,45.73750286,7.320149366,1,0,1,12,13,0,1050,146,1209,15819
3422,8,4,ITA,5,Veneto,45.43490485,12.33845213,32,5,37,1028,1065,20,17111,2077,20253,494299
3423,8,5,ITA,13,Abruzzo,42.35122196,13.39843823,19,1,20,120,140,19,2808,472,3420,86563
3424,8,5,ITA,17,Basilicata,40.63947052,15.80514834,2,0,2,51,53,1,373,28,454,47416
3425,8,5,ITA,18,Calabria,38.90597598,16.59440194,6,1,7,94,101,2,1076,97,1274,122492
3426,8,5,ITA,15,Campania,40.83956555,14.25084984,44,1,45,349,394,8,4198,438,5030,177414
3427,8,5,ITA,8,Emilia-Romagna,44.49436681,11.3417208,73,4,77,1532,1609,47,23997,4291,29897,418046
3428,8,5,ITA,6,Friuli Venezia Giulia,45.6494354,13.76813649,8,2,10,137,147,9,2932,346,3425,128698
3429,8,5,ITA,12,Lazio,41.89277044,12.48366722,188,7,195,788,983,12,6878,865,8726,353130
3430,8,5,ITA,7,Liguria,44.41149315,8.9326992,18,0,18,189,207,7,8475,1568,10250,104340
3431,8,5,ITA,3,Lombardia,45.46679409,9.190347404,164,11,175,5648,5823,138,73872,16824,96519,803355
3432,8,5,ITA,11,Marche,43.61675973,13.5188753,15,0,15,122,137,6,5781,987,6905,102536
3433,8,5,ITA,14,Molise,41.55774754,14.65916051,1,0,1,33,34,1,421,23,478,27346
3434,8,5,ITA,21,P.A. Bolzano,46.49933453,11.35662422,8,0,8,108,116,5,2337,292,2745,56638
3435,8,5,ITA,22,P.A. Trento,46.06893511,11.12123097,3,0,3,76,79,1,4500,405,4984,73665
3436,8,5,ITA,1,Piemonte,45.0732745,7.680687483,94,4,98,682,780,21,26826,4134,31740,311770
3437,8,5,ITA,16,Puglia,41.12559576,16.86736689,24,0,24,128,152,23,3973,553,4678,171932
3438,8,5,ITA,20,Sardegna,39.21531192,9.110616306,5,0,5,48,53,9,1240,134,1427,93176
3439,8,5,ITA,19,Sicilia,38.11569725,13.3623567,34,4,38,276,314,21,2741,284,3339,223645
3440,8,5,ITA,9,Toscana,43.76923077,11.25588885,18,0,18,397,415,11,8978,1137,10530,289710
3441,8,5,ITA,10,Umbria,43.10675841,12.38824698,6,0,6,24,30,2,1369,80,1479,80145
3442,8,5,ITA,2,Valle d'Aosta,45.73750286,7.320149366,1,0,1,11,12,0,1051,146,1209,15855
3443,8,5,ITA,5,Veneto,45.43490485,12.33845213,33,6,39,1028,1067,41,17150,2077,20294,496893
3444,8,6,ITA,13,Abruzzo,42.35122196,13.39843823,20,1,21,132,153,15,2810,472,3435,86980
3445,8,6,ITA,17,Basilicata,40.63947052,15.80514834,2,0,2,51,53,0,373,28,454,47783
3446,8,6,ITA,18,Calabria,38.90597598,16.59440194,7,1,8,83,91,2,1088,97,1276,123359
3447,8,6,ITA,15,Campania,40.83956555,14.25084984,20,1,21,364,385,5,4212,438,5035,179583
3448,8,6,ITA,8,Emilia-Romagna,44.49436681,11.3417208,78,4,82,1570,1652,58,24011,4291,29954,423543
3449,8,6,ITA,6,Friuli Venezia Giulia,45.6494354,13.76813649,11,2,13,140,153,7,2933,346,3432,129283
3450,8,6,ITA,12,Lazio,41.89277044,12.48366722,185,8,193,800,993,18,6886,865,8744,355838
3451,8,6,ITA,7,Liguria,44.41149315,8.9326992,20,0,20,190,210,13,8485,1568,10263,105218
3452,8,6,ITA,3,Lombardia,45.46679409,9.190347404,168,11,179,5549,5728,118,74080,16829,96637,808787
3453,8,6,ITA,11,Marche,43.61675973,13.5188753,16,0,16,125,141,9,5786,987,6914,103309
3454,8,6,ITA,14,Molise,41.55774754,14.65916051,1,0,1,33,34,0,421,23,478,27530
3455,8,6,ITA,21,P.A. Bolzano,46.49933453,11.35662422,8,0,8,116,124,12,2341,292,2757,57346
3456,8,6,ITA,22,P.A. Trento,46.06893511,11.12123097,3,0,3,77,80,4,4503,405,4988,74061
3457,8,6,ITA,1,Piemonte,45.0732745,7.680687483,90,4,94,684,778,22,26849,4135,31762,313748
3458,8,6,ITA,16,Puglia,41.12559576,16.86736689,24,0,24,134,158,7,3974,553,4685,173426
3459,8,6,ITA,20,Sardegna,39.21531192,9.110616306,7,0,7,48,55,3,1241,134,1430,93975
3460,8,6,ITA,19,Sicilia,38.11569725,13.3623567,37,4,41,301,342,30,2743,284,3369,225491
3461,8,6,ITA,9,Toscana,43.76923077,11.25588885,20,0,20,405,425,17,8985,1137,10547,291429
3462,8,6,ITA,10,Umbria,43.10675841,12.38824698,8,0,8,21,29,3,1373,80,1482,80599
3463,8,6,ITA,2,Valle d'Aosta,45.73750286,7.320149366,1,0,1,12,13,1,1051,146,1210,15940
3464,8,6,ITA,5,Veneto,45.43490485,12.33845213,36,6,42,1055,1097,58,17178,2077,20352,499706
3465,8,7,ITA,13,Abruzzo,42.35122196,13.39843823,22,1,23,167,190,39,2812,472,3474,87440
3466,8,7,ITA,17,Basilicata,40.63947052,15.80514834,2,0,2,72,74,21,373,28,475,48092
3467,8,7,ITA,18,Calabria,38.90597598,16.59440194,7,1,8,89,97,7,1089,97,1283,124400
3468,8,7,ITA,15,Campania,40.83956555,14.25084984,32,2,34,338,372,15,4240,438,5050,180679
3469,8,7,ITA,8,Emilia-Romagna,44.49436681,11.3417208,79,4,83,1592,1675,54,24041,4292,30008,429300
3470,8,7,ITA,6,Friuli Venezia Giulia,45.6494354,13.76813649,13,3,16,139,155,4,2935,346,3436,129930
3471,8,7,ITA,12,Lazio,41.89277044,12.48366722,184,8,192,816,1008,20,6891,865,8764,357556
3472,8,7,ITA,7,Liguria,44.41149315,8.9326992,22,1,23,193,216,9,8488,1568,10272,105914
3473,8,7,ITA,3,Lombardia,45.46679409,9.190347404,170,9,179,5466,5645,69,74232,16829,96706,813260
3474,8,7,ITA,11,Marche,43.61675973,13.5188753,13,0,13,145,158,21,5790,987,6935,103904
3475,8,7,ITA,14,Molise,41.55774754,14.65916051,1,0,1,34,35,1,421,23,479,27685
3476,8,7,ITA,21,P.A. Bolzano,46.49933453,11.35662422,8,0,8,120,128,4,2341,292,2761,57987
3477,8,7,ITA,22,P.A. Trento,46.06893511,11.12123097,5,0,5,77,82,4,4505,405,4992,74347
3478,8,7,ITA,1,Piemonte,45.0732745,7.680687483,88,3,91,701,792,37,26871,4136,31799,315167
3479,8,7,ITA,16,Puglia,41.12559576,16.86736689,26,0,26,144,170,11,3973,553,4696,174742
3480,8,7,ITA,20,Sardegna,39.21531192,9.110616306,8,0,8,50,58,3,1241,134,1433,94626
3481,8,7,ITA,19,Sicilia,38.11569725,13.3623567,37,4,41,328,369,27,2743,284,3396,226979
3482,8,7,ITA,9,Toscana,43.76923077,11.25588885,18,0,18,417,435,13,8988,1137,10560,292933
3483,8,7,ITA,10,Umbria,43.10675841,12.38824698,8,0,8,25,33,6,1375,80,1488,80959
3484,8,7,ITA,2,Valle d'Aosta,45.73750286,7.320149366,5,0,5,12,17,4,1051,146,1214,15985
3485,8,7,ITA,5,Veneto,45.43490485,12.33845213,31,6,37,1178,1215,183,17242,2078,20535,505441
3486,8,8,ITA,13,Abruzzo,42.35122196,13.39843823,24,1,25,172,197,12,2817,472,3486,87799
3487,8,8,ITA,17,Basilicata,40.63947052,15.80514834,2,0,2,73,75,1,373,28,476,48319
3488,8,8,ITA,18,Calabria,38.90597598,16.59440194,9,1,10,91,101,4,1089,97,1287,125275
3489,8,8,ITA,15,Campania,40.83956555,14.25084984,32,2,34,338,372,5,4245,438,5055,181846
3490,8,8,ITA,8,Emilia-Romagna,44.49436681,11.3417208,81,4,85,1627,1712,44,24046,4294,30052,434744
3491,8,8,ITA,6,Friuli Venezia Giulia,45.6494354,13.76813649,11,3,14,146,160,6,2936,346,3442,130500
3492,8,8,ITA,12,Lazio,41.89277044,12.48366722,189,8,197,820,1017,20,6901,866,8784,359225
3493,8,8,ITA,7,Liguria,44.41149315,8.9326992,20,1,21,193,214,4,8493,1569,10276,105987
3494,8,8,ITA,3,Lombardia,45.46679409,9.190347404,162,9,171,5376,5547,76,74403,16832,96782,816988
3495,8,8,ITA,11,Marche,43.61675973,13.5188753,14,0,14,142,156,3,5795,987,6938,104534
3496,8,8,ITA,14,Molise,41.55774754,14.65916051,1,0,1,34,35,0,421,23,479,27851
3497,8,8,ITA,21,P.A. Bolzano,46.49933453,11.35662422,8,0,8,115,123,5,2351,292,2766,58633
3498,8,8,ITA,22,P.A. Trento,46.06893511,11.12123097,5,0,5,74,79,1,4509,405,4993,74756
3499,8,8,ITA,1,Piemonte,45.0732745,7.680687483,87,3,90,700,790,31,26904,4136,31830,316746
3500,8,8,ITA,16,Puglia,41.12559576,16.86736689,27,0,27,151,178,9,3973,554,4705,176113
3501,8,8,ITA,20,Sardegna,39.21531192,9.110616306,6,0,6,48,54,0,1245,134,1433,95280
3502,8,8,ITA,19,Sicilia,38.11569725,13.3623567,37,4,41,356,397,28,2743,284,3424,228395
3503,8,8,ITA,9,Toscana,43.76923077,11.25588885,14,1,15,442,457,23,8989,1137,10583,294690
3504,8,8,ITA,10,Umbria,43.10675841,12.38824698,8,0,8,34,42,10,1376,80,1498,81336
3505,8,8,ITA,2,Valle d'Aosta,45.73750286,7.320149366,5,0,5,14,19,2,1051,146,1216,16048
3506,8,8,ITA,5,Veneto,45.43490485,12.33845213,29,6,35,1193,1228,63,17287,2083,20598,508892
3507,8,9,ITA,13,Abruzzo,42.35122196,13.39843823,23,1,24,189,213,16,2817,472,3502,88565
3508,8,9,ITA,17,Basilicata,40.63947052,15.80514834,2,0,2,73,75,0,373,28,476,48319
3509,8,9,ITA,18,Calabria,38.90597598,16.59440194,9,1,10,90,100,0,1090,97,1287,125829
3510,8,9,ITA,15,Campania,40.83956555,14.25084984,29,2,31,357,388,22,4251,438,5077,182840
3511,8,9,ITA,8,Emilia-Romagna,44.49436681,11.3417208,81,4,85,1675,1760,69,24066,4295,30121,438547
3512,8,9,ITA,6,Friuli Venezia Giulia,45.6494354,13.76813649,11,3,14,152,166,7,2937,346,3449,131023
3513,8,9,ITA,12,Lazio,41.89277044,12.48366722,189,8,197,849,1046,38,6910,866,8822,361238
3514,8,9,ITA,7,Liguria,44.41149315,8.9326992,20,2,22,194,216,7,8498,1569,10283,107771
3515,8,9,ITA,3,Lombardia,45.46679409,9.190347404,155,9,164,5424,5588,71,74432,16833,96853,820541
3516,8,9,ITA,11,Marche,43.61675973,13.5188753,13,0,13,155,168,16,5799,987,6954,105247
3517,8,9,ITA,14,Molise,41.55774754,14.65916051,1,0,1,34,35,0,421,23,479,27928
3518,8,9,ITA,21,P.A. Bolzano,46.49933453,11.35662422,8,0,8,120,128,7,2353,292,2773,59260
3519,8,9,ITA,22,P.A. Trento,46.06893511,11.12123097,6,0,6,72,78,2,4512,405,4995,75038
3520,8,9,ITA,1,Piemonte,45.0732745,7.680687483,85,3,88,734,822,38,26910,4136,31868,318480
3521,8,9,ITA,16,Puglia,41.12559576,16.86736689,31,0,31,156,187,9,3973,554,4714,176992
3522,8,9,ITA,20,Sardegna,39.21531192,9.110616306,6,0,6,54,60,6,1245,134,1439,95686
3523,8,9,ITA,19,Sicilia,38.11569725,13.3623567,39,5,44,376,420,29,2749,284,3453,229444
3524,8,9,ITA,9,Toscana,43.76923077,11.25588885,14,1,15,495,510,61,8997,1137,10644,296406
3525,8,9,ITA,10,Umbria,43.10675841,12.38824698,8,0,8,41,49,7,1376,80,1505,81605
3526,8,9,ITA,2,Valle d'Aosta,45.73750286,7.320149366,5,0,5,9,14,0,1056,146,1216,16120
3527,8,9,ITA,5,Veneto,45.43490485,12.33845213,28,6,34,1206,1240,58,17333,2083,20656,509851
3528,8,10,ITA,13,Abruzzo,42.35122196,13.39843823,24,1,25,194,219,7,2818,472,3509,88650
3529,8,10,ITA,17,Basilicata,40.63947052,15.80514834,0,0,0,72,72,0,376,28,476,48602
3530,8,10,ITA,18,Calabria,38.90597598,16.59440194,8,1,9,92,101,2,1091,97,1289,126156
3531,8,10,ITA,15,Campania,40.83956555,14.25084984,34,1,35,363,398,14,4254,439,5091,183401
3532,8,10,ITA,8,Emilia-Romagna,44.49436681,11.3417208,79,4,83,1708,1791,39,24073,4296,30160,440041
3533,8,10,ITA,6,Friuli Venezia Giulia,45.6494354,13.76813649,10,3,13,151,164,0,2938,347,3449,131332
3534,8,10,ITA,12,Lazio,41.89277044,12.48366722,195,8,203,878,1081,38,6912,867,8860,362827
3535,8,10,ITA,7,Liguria,44.41149315,8.9326992,20,2,22,190,212,10,8512,1569,10293,108164
3536,8,10,ITA,3,Lombardia,45.46679409,9.190347404,150,9,159,5388,5547,31,74504,16833,96884,822142
3537,8,10,ITA,11,Marche,43.61675973,13.5188753,11,0,11,154,165,2,5804,987,6956,105420
3538,8,10,ITA,14,Molise,41.55774754,14.65916051,1,0,1,32,33,0,423,23,479,28003
3539,8,10,ITA,21,P.A. Bolzano,46.49933453,11.35662422,8,0,8,120,128,1,2354,292,2774,59515
3540,8,10,ITA,22,P.A. Trento,46.06893511,11.12123097,7,0,7,72,79,1,4512,405,4996,75139
3541,8,10,ITA,1,Piemonte,45.0732745,7.680687483,87,3,90,719,809,20,26943,4136,31888,318659
3542,8,10,ITA,16,Puglia,41.12559576,16.86736689,36,1,37,176,213,26,3973,554,4740,177798
3543,8,10,ITA,20,Sardegna,39.21531192,9.110616306,6,0,6,56,62,2,1245,134,1441,95974
3544,8,10,ITA,19,Sicilia,38.11569725,13.3623567,45,6,51,399,450,32,2751,284,3485,230105
3545,8,10,ITA,9,Toscana,43.76923077,11.25588885,16,1,17,501,518,8,8997,1137,10652,297261
3546,8,10,ITA,10,Umbria,43.10675841,12.38824698,8,0,8,46,54,5,1376,80,1510,81825
3547,8,10,ITA,2,Valle d'Aosta,45.73750286,7.320149366,5,0,5,10,15,1,1056,146,1217,16161
3548,8,10,ITA,5,Veneto,45.43490485,12.33845213,29,6,35,1222,1257,20,17336,2083,20676,510459
3549,8,11,ITA,13,Abruzzo,42.35122196,13.39843823,23,1,24,195,219,3,2821,472,3512,88902
3550,8,11,ITA,17,Basilicata,40.63947052,15.80514834,0,0,0,73,73,1,376,28,477,48851
3551,8,11,ITA,18,Calabria,38.90597598,16.59440194,8,1,9,103,112,11,1091,97,1300,127102
3552,8,11,ITA,15,Campania,40.83956555,14.25084984,44,2,46,356,402,23,4272,440,5114,184220
3553,8,11,ITA,8,Emilia-Romagna,44.49436681,11.3417208,76,4,80,1710,1790,19,24091,4298,30179,442538
3554,8,11,ITA,6,Friuli Venezia Giulia,45.6494354,13.76813649,8,3,11,145,156,3,2948,348,3452,132027
3555,8,11,ITA,12,Lazio,41.89277044,12.48366722,203,9,212,889,1101,23,6915,867,8883,364395
3556,8,11,ITA,7,Liguria,44.41149315,8.9326992,18,2,20,203,223,11,8512,1569,10304,108894
3557,8,11,ITA,3,Lombardia,45.46679409,9.190347404,160,10,170,5344,5514,68,74605,16833,96952,824917
3558,8,11,ITA,11,Marche,43.61675973,13.5188753,11,0,11,151,162,4,5811,987,6960,106017
3559,8,11,ITA,14,Molise,41.55774754,14.65916051,1,0,1,32,33,0,423,23,479,28105
3560,8,11,ITA,21,P.A. Bolzano,46.49933453,11.35662422,6,0,6,122,128,1,2355,292,2775,59794
3561,8,11,ITA,22,P.A. Trento,46.06893511,11.12123097,5,0,5,70,75,2,4518,405,4998,75417
3562,8,11,ITA,1,Piemonte,45.0732745,7.680687483,85,3,88,734,822,26,26956,4136,31914,319943
3563,8,11,ITA,16,Puglia,41.12559576,16.86736689,38,1,39,190,229,20,3977,554,4760,179205
3564,8,11,ITA,20,Sardegna,39.21531192,9.110616306,6,0,6,76,82,20,1245,134,1461,96725
3565,8,11,ITA,19,Sicilia,38.11569725,13.3623567,44,6,50,488,538,89,2752,284,3574,231949
3566,8,11,ITA,9,Toscana,43.76923077,11.25588885,18,1,19,516,535,22,9002,1137,10674,298892
3567,8,11,ITA,10,Umbria,43.10675841,12.38824698,9,0,9,43,52,1,1379,80,1511,82253
3568,8,11,ITA,2,Valle d'Aosta,45.73750286,7.320149366,5,0,5,10,15,0,1056,146,1217,16228
3569,8,11,ITA,5,Veneto,45.43490485,12.33845213,33,6,39,1261,1300,65,17356,2085,20741,513323
3570,8,12,ITA,13,Abruzzo,42.35122196,13.39843823,23,1,24,197,221,9,2823,472,3516,89381
3571,8,12,ITA,17,Basilicata,40.63947052,15.80514834,0,0,0,72,72,0,377,28,477,49129
3572,8,12,ITA,18,Calabria,38.90597598,16.59440194,8,1,9,101,110,4,1097,97,1304,128194
3573,8,12,ITA,15,Campania,40.83956555,14.25084984,43,2,45,379,424,29,4279,440,5143,185318
3574,8,12,ITA,8,Emilia-Romagna,44.49436681,11.3417208,78,4,82,1725,1807,41,24115,4298,30220,446202
3575,8,12,ITA,6,Friuli Venezia Giulia,45.6494354,13.76813649,7,3,10,154,164,9,2949,348,3461,132663
3576,8,12,ITA,12,Lazio,41.89277044,12.48366722,190,9,199,922,1121,37,6931,868,8920,366246
3577,8,12,ITA,7,Liguria,44.41149315,8.9326992,17,2,19,208,227,26,8534,1569,10330,109799
3578,8,12,ITA,3,Lombardia,45.46679409,9.190347404,165,10,175,5346,5521,102,74700,16833,97054,829237
3579,8,12,ITA,11,Marche,43.61675973,13.5188753,10,0,10,157,167,16,5822,987,6976,106614
3580,8,12,ITA,14,Molise,41.55774754,14.65916051,0,0,0,29,29,0,427,23,479,28265
3581,8,12,ITA,21,P.A. Bolzano,46.49933453,11.35662422,6,0,6,124,130,4,2357,292,2779,60969
3582,8,12,ITA,22,P.A. Trento,46.06893511,11.12123097,2,1,3,65,68,0,4525,405,4998,75685
3583,8,12,ITA,1,Piemonte,45.0732745,7.680687483,76,3,79,776,855,42,26963,4138,31956,321651
3584,8,12,ITA,16,Puglia,41.12559576,16.86736689,43,2,45,217,262,33,3977,554,4793,180855
3585,8,12,ITA,20,Sardegna,39.21531192,9.110616306,6,0,6,77,83,1,1245,134,1462,97340
3586,8,12,ITA,19,Sicilia,38.11569725,13.3623567,43,6,49,513,562,29,2757,284,3603,233597
3587,8,12,ITA,9,Toscana,43.76923077,11.25588885,15,3,18,545,563,33,9007,1137,10707,300764
3588,8,12,ITA,10,Umbria,43.10675841,12.38824698,9,0,9,48,57,6,1380,80,1517,82645
3589,8,12,ITA,2,Valle d'Aosta,45.73750286,7.320149366,5,0,5,10,15,0,1056,146,1217,16342
3590,8,12,ITA,5,Veneto,45.43490485,12.33845213,33,6,39,1294,1333,60,17376,2092,20801,516131
3591,8,13,ITA,13,Abruzzo,42.35122196,13.39843823,24,1,25,209,234,16,2826,472,3532,89847
3592,8,13,ITA,17,Basilicata,40.63947052,15.80514834,0,0,0,73,73,1,377,28,478,49448
3593,8,13,ITA,18,Calabria,38.90597598,16.59440194,8,1,9,110,119,12,1100,97,1316,129359
3594,8,13,ITA,15,Campania,40.83956555,14.25084984,38,2,40,407,447,27,4283,440,5170,186543
3595,8,13,ITA,8,Emilia-Romagna,44.49436681,11.3417208,79,4,83,1744,1827,37,24132,4298,30257,449766
3596,8,13,ITA,6,Friuli Venezia Giulia,45.6494354,13.76813649,7,3,10,166,176,15,2952,348,3476,133284
3597,8,13,ITA,12,Lazio,41.89277044,12.48366722,195,9,204,923,1127,36,6960,869,8956,367897
3598,8,13,ITA,7,Liguria,44.41149315,8.9326992,20,2,22,235,257,63,8567,1569,10393,110755
3599,8,13,ITA,3,Lombardia,45.46679409,9.190347404,170,11,181,5358,5539,74,74754,16835,97128,833060
3600,8,13,ITA,11,Marche,43.61675973,13.5188753,8,0,8,161,169,11,5831,987,6987,107237
3601,8,13,ITA,14,Molise,41.55774754,14.65916051,0,0,0,35,35,6,427,23,485,28421
3602,8,13,ITA,21,P.A. Bolzano,46.49933453,11.35662422,7,1,8,114,122,3,2367,292,2781,61905
3603,8,13,ITA,22,P.A. Trento,46.06893511,11.12123097,1,1,2,61,63,2,4532,405,5000,76012
3604,8,13,ITA,1,Piemonte,45.0732745,7.680687483,77,3,80,784,864,26,26979,4139,31982,322956
3605,8,13,ITA,16,Puglia,41.12559576,16.86736689,46,2,48,228,276,16,3979,554,4809,182067
3606,8,13,ITA,20,Sardegna,39.21531192,9.110616306,8,0,8,90,98,17,1247,134,1479,98236
3607,8,13,ITA,19,Sicilia,38.11569725,13.3623567,42,6,48,556,604,42,2757,284,3645,234950
3608,8,13,ITA,9,Toscana,43.76923077,11.25588885,13,3,16,574,590,28,9008,1137,10735,302546
3609,8,13,ITA,10,Umbria,43.10675841,12.38824698,10,0,10,52,62,7,1382,80,1524,83046
3610,8,13,ITA,2,Valle d'Aosta,45.73750286,7.320149366,3,0,3,11,14,0,1057,146,1217,16397
3611,8,13,ITA,5,Veneto,45.43490485,12.33845213,30,6,36,1349,1385,84,17406,2094,20885,518924
3612,8,14,ITA,13,Abruzzo,42.35122196,13.39843823,23,1,24,218,242,13,2831,472,3545,90264
3613,8,14,ITA,17,Basilicata,40.63947052,15.80514834,0,0,0,64,64,4,390,28,482,49836
3614,8,14,ITA,18,Calabria,38.90597598,16.59440194,7,1,8,125,133,19,1105,97,1335,130543
3615,8,14,ITA,15,Campania,40.83956555,14.25084984,47,1,48,439,487,44,4287,440,5214,188242
3616,8,14,ITA,8,Emilia-Romagna,44.49436681,11.3417208,76,4,80,1786,1866,57,24150,4298,30314,452995
3617,8,14,ITA,6,Friuli Venezia Giulia,45.6494354,13.76813649,3,3,6,177,183,8,2953,348,3484,133870
3618,8,14,ITA,12,Lazio,41.89277044,12.48366722,192,9,201,964,1165,45,6966,870,9001,369749
3619,8,14,ITA,7,Liguria,44.41149315,8.9326992,17,3,20,252,272,20,8572,1569,10413,111663
3620,8,14,ITA,3,Lombardia,45.46679409,9.190347404,153,12,165,5212,5377,97,75012,16836,97225,837083
3621,8,14,ITA,11,Marche,43.61675973,13.5188753,10,1,11,179,190,32,5842,987,7019,107918
3622,8,14,ITA,14,Molise,41.55774754,14.65916051,0,0,0,35,35,0,427,23,485,28498
3623,8,14,ITA,21,P.A. Bolzano,46.49933453,11.35662422,7,1,8,115,123,3,2369,292,2784,62599
3624,8,14,ITA,22,P.A. Trento,46.06893511,11.12123097,2,1,3,60,63,3,4535,405,5003,76300
3625,8,14,ITA,1,Piemonte,45.0732745,7.680687483,77,3,80,794,874,15,26984,4139,31997,323723
3626,8,14,ITA,16,Puglia,41.12559576,16.86736689,45,1,46,240,286,12,3981,554,4821,183493
3627,8,14,ITA,20,Sardegna,39.21531192,9.110616306,8,0,8,95,103,5,1247,134,1484,98662
3628,8,14,ITA,19,Sicilia,38.11569725,13.3623567,46,6,52,579,631,36,2766,284,3681,236593
3629,8,14,ITA,9,Toscana,43.76923077,11.25588885,12,3,15,589,604,26,9020,1137,10761,304412
3630,8,14,ITA,10,Umbria,43.10675841,12.38824698,10,0,10,58,68,8,1384,80,1532,83413
3631,8,14,ITA,2,Valle d'Aosta,45.73750286,7.320149366,3,0,3,10,13,0,1058,146,1217,16436
3632,8,14,ITA,5,Veneto,45.43490485,12.33845213,33,6,39,1431,1470,127,17447,2095,21012,521232
3633,8,15,ITA,13,Abruzzo,42.35122196,13.39843823,25,1,26,226,252,13,2834,472,3558,91060
3634,8,15,ITA,17,Basilicata,40.63947052,15.80514834,0,0,0,66,66,4,392,28,486,50066
3635,8,15,ITA,18,Calabria,38.90597598,16.59440194,8,1,9,134,143,10,1105,97,1345,132030
3636,8,15,ITA,15,Campania,40.83956555,14.25084984,34,1,35,454,489,18,4303,440,5232,189377
3637,8,15,ITA,8,Emilia-Romagna,44.49436681,11.3417208,75,4,79,1675,1754,71,24178,4453,30385,456025
3638,8,15,ITA,6,Friuli Venezia Giulia,45.6494354,13.76813649,2,3,5,184,189,15,2962,348,3499,134780
3639,8,15,ITA,12,Lazio,41.89277044,12.48366722,193,9,202,1016,1218,58,6971,870,9059,371681
3640,8,15,ITA,7,Liguria,44.41149315,8.9326992,17,3,20,253,273,33,8604,1569,10446,112680
3641,8,15,ITA,3,Lombardia,45.46679409,9.190347404,149,12,161,5196,5357,94,75125,16837,97319,840083
3642,8,15,ITA,11,Marche,43.61675973,13.5188753,13,1,14,180,194,11,5849,987,7030,108605
3643,8,15,ITA,14,Molise,41.55774754,14.65916051,0,0,0,35,35,2,429,23,487,28711
3644,8,15,ITA,21,P.A. Bolzano,46.49933453,11.35662422,7,1,8,118,126,9,2375,292,2793,63420
3645,8,15,ITA,22,P.A. Trento,46.06893511,11.12123097,1,1,2,58,60,0,4538,405,5003,76702
3646,8,15,ITA,1,Piemonte,45.0732745,7.680687483,81,3,84,796,880,47,27025,4139,32044,324996
3647,8,15,ITA,16,Puglia,41.12559576,16.86736689,46,1,47,261,308,22,3981,554,4843,184587
3648,8,15,ITA,20,Sardegna,39.21531192,9.110616306,8,0,8,93,101,5,1254,134,1489,99203
3649,8,15,ITA,19,Sicilia,38.11569725,13.3623567,47,5,52,625,677,46,2766,284,3727,237998
3650,8,15,ITA,9,Toscana,43.76923077,11.25588885,9,4,13,620,633,38,9028,1138,10799,306566
3651,8,15,ITA,10,Umbria,43.10675841,12.38824698,9,1,10,70,80,13,1385,80,1545,83936
3652,8,15,ITA,2,Valle d'Aosta,45.73750286,7.320149366,2,0,2,9,11,0,1060,146,1217,16512
3653,8,15,ITA,5,Veneto,45.43490485,12.33845213,38,4,42,1518,1560,120,17476,2096,21132,524443
3654,8,16,ITA,13,Abruzzo,42.35122196,13.39843823,25,1,26,228,254,2,2834,472,3560,91242
3655,8,16,ITA,17,Basilicata,40.63947052,15.80514834,0,0,0,65,65,0,392,28,485,50066
3656,8,16,ITA,18,Calabria,38.90597598,16.59440194,9,1,10,136,146,3,1105,97,1348,133706
3657,8,16,ITA,15,Campania,40.83956555,14.25084984,43,1,44,489,533,46,4305,440,5278,191738
3658,8,16,ITA,8,Emilia-Romagna,44.49436681,11.3417208,74,4,78,1727,1805,51,24178,4453,30436,458446
3659,8,16,ITA,6,Friuli Venezia Giulia,45.6494354,13.76813649,3,3,6,190,196,8,2963,348,3507,135467
3660,8,16,ITA,12,Lazio,41.89277044,12.48366722,204,9,213,1071,1284,68,6973,870,9127,373861
3661,8,16,ITA,7,Liguria,44.41149315,8.9326992,19,3,22,263,285,12,8604,1569,10458,113221
3662,8,16,ITA,3,Lombardia,45.46679409,9.190347404,147,13,160,5217,5377,61,75163,16840,97380,843250
3663,8,16,ITA,11,Marche,43.61675973,13.5188753,12,1,13,181,194,5,5854,987,7035,109134
3664,8,16,ITA,14,Molise,41.55774754,14.65916051,0,0,0,35,35,0,429,23,487,28770
3665,8,16,ITA,21,P.A. Bolzano,46.49933453,11.35662422,7,1,8,121,129,9,2381,292,2802,63890
3666,8,16,ITA,22,P.A. Trento,46.06893511,11.12123097,1,1,2,57,59,0,4539,405,5003,76846
3667,8,16,ITA,1,Piemonte,45.0732745,7.680687483,80,3,83,782,865,40,27080,4139,32084,326513
3668,8,16,ITA,16,Puglia,41.12559576,16.86736689,47,1,48,275,323,15,3981,554,4858,185276
3669,8,16,ITA,20,Sardegna,39.21531192,9.110616306,8,0,8,97,105,5,1254,134,1493,99495
3670,8,16,ITA,19,Sicilia,38.11569725,13.3623567,51,5,56,656,712,39,2769,285,3766,238872
3671,8,16,ITA,9,Toscana,43.76923077,11.25588885,10,4,14,653,667,34,9028,1138,10833,307863
3672,8,16,ITA,10,Umbria,43.10675841,12.38824698,10,1,11,72,83,3,1385,80,1548,84080
3673,8,16,ITA,2,Valle d'Aosta,45.73750286,7.320149366,2,0,2,7,9,0,1062,146,1217,16543
3674,8,16,ITA,5,Veneto,45.43490485,12.33845213,35,4,39,1568,1607,78,17507,2096,21210,527652
3675,8,17,ITA,13,Abruzzo,42.35122196,13.39843823,27,1,28,227,255,5,2838,472,3565,91479
3676,8,17,ITA,17,Basilicata,40.63947052,15.80514834,0,0,0,65,65,0,392,28,485,50219
3677,8,17,ITA,18,Calabria,38.90597598,16.59440194,8,1,9,140,149,4,1106,97,1352,134570
3678,8,17,ITA,15,Campania,40.83956555,14.25084984,47,1,48,519,567,34,4305,440,5312,192706
3679,8,17,ITA,8,Emilia-Romagna,44.49436681,11.3417208,74,4,78,1736,1814,41,24210,4453,30477,459964
3680,8,17,ITA,6,Friuli Venezia Giulia,45.6494354,13.76813649,6,3,9,192,201,5,2963,348,3512,136278
3681,8,17,ITA,12,Lazio,41.89277044,12.48366722,212,9,221,1108,1329,51,6979,870,9178,375815
3682,8,17,ITA,7,Liguria,44.41149315,8.9326992,22,3,25,270,295,16,8610,1569,10474,113740
3683,8,17,ITA,3,Lombardia,45.46679409,9.190347404,147,14,161,5174,5335,43,75248,16840,97423,845795
3684,8,17,ITA,11,Marche,43.61675973,13.5188753,12,1,13,182,195,8,5861,987,7043,109554
3685,8,17,ITA,14,Molise,41.55774754,14.65916051,0,0,0,35,35,0,429,23,487,28843
3686,8,17,ITA,21,P.A. Bolzano,46.49933453,11.35662422,8,1,9,118,127,2,2385,292,2804,64243
3687,8,17,ITA,22,P.A. Trento,46.06893511,11.12123097,1,1,2,57,59,1,4540,405,5004,76936
3688,8,17,ITA,1,Piemonte,45.0732745,7.680687483,75,2,77,797,874,16,27086,4140,32100,327181
3689,8,17,ITA,16,Puglia,41.12559576,16.86736689,49,2,51,274,325,4,3982,555,4862,186287
3690,8,17,ITA,20,Sardegna,39.21531192,9.110616306,9,0,9,101,110,7,1256,134,1500,99783
3691,8,17,ITA,19,Sicilia,38.11569725,13.3623567,54,6,60,658,718,14,2776,286,3780,240106
3692,8,17,ITA,9,Toscana,43.76923077,11.25588885,11,4,15,672,687,21,9028,1139,10854,309024
3693,8,17,ITA,10,Umbria,43.10675841,12.38824698,10,1,11,74,85,1,1384,80,1549,84328
3694,8,17,ITA,2,Valle d'Aosta,45.73750286,7.320149366,1,0,1,7,8,1,1064,146,1218,16635
3695,8,17,ITA,5,Veneto,45.43490485,12.33845213,37,4,41,1593,1634,46,17526,2096,21256,533824
3696,8,18,ITA,13,Abruzzo,42.35122196,13.39843823,27,1,28,230,258,5,2840,472,3570,91835
3697,8,18,ITA,17,Basilicata,40.63947052,15.80514834,0,0,0,70,70,8,393,28,491,50588
3698,8,18,ITA,18,Calabria,38.90597598,16.59440194,10,1,11,143,154,5,1106,97,1357,136044
3699,8,18,ITA,15,Campania,40.83956555,14.25084984,49,2,51,545,596,35,4311,440,5347,195069
3700,8,18,ITA,8,Emilia-Romagna,44.49436681,11.3417208,72,4,76,1713,1789,21,24255,4454,30498,463421
3701,8,18,ITA,6,Friuli Venezia Giulia,45.6494354,13.76813649,5,3,8,196,204,10,2970,348,3522,137468
3702,8,18,ITA,12,Lazio,41.89277044,12.48366722,218,6,224,1135,1359,43,6991,871,9221,378384
3703,8,18,ITA,7,Liguria,44.41149315,8.9326992,25,1,26,296,322,27,8610,1569,10501,114701
3704,8,18,ITA,3,Lombardia,45.46679409,9.190347404,150,14,164,5150,5314,50,75319,16840,97473,849579
3705,8,18,ITA,11,Marche,43.61675973,13.5188753,13,1,14,191,205,15,5866,987,7058,110364
3706,8,18,ITA,14,Molise,41.55774754,14.65916051,0,0,0,44,44,9,429,23,496,29022
3707,8,18,ITA,21,P.A. Bolzano,46.49933453,11.35662422,8,1,9,118,127,0,2385,292,2804,64618
3708,8,18,ITA,22,P.A. Trento,46.06893511,11.12123097,2,1,3,56,59,2,4542,405,5006,77285
3709,8,18,ITA,1,Piemonte,45.0732745,7.680687483,80,3,83,814,897,27,27089,4141,32127,328753
3710,8,18,ITA,16,Puglia,41.12559576,16.86736689,53,3,56,284,340,20,3987,555,4882,188150
3711,8,18,ITA,20,Sardegna,39.21531192,9.110616306,9,0,9,113,122,12,1256,134,1512,100605
3712,8,18,ITA,19,Sicilia,38.11569725,13.3623567,54,6,60,662,722,13,2785,286,3793,241613
3713,8,18,ITA,9,Toscana,43.76923077,11.25588885,16,4,20,698,718,31,9028,1139,10885,311146
3714,8,18,ITA,10,Umbria,43.10675841,12.38824698,9,1,10,83,93,10,1386,80,1559,85191
3715,8,18,ITA,2,Valle d'Aosta,45.73750286,7.320149366,1,0,1,7,8,0,1064,146,1218,16690
3716,8,18,ITA,5,Veneto,45.43490485,12.33845213,42,6,48,1640,1688,60,17530,2098,21316,539471
3717,8,19,ITA,13,Abruzzo,42.35122196,13.39843823,25,2,27,238,265,7,2840,472,3577,92656
3718,8,19,ITA,17,Basilicata,40.63947052,15.80514834,0,0,0,71,71,1,393,28,492,50838
3719,8,19,ITA,18,Calabria,38.90597598,16.59440194,10,1,11,139,150,10,1120,97,1367,137560
3720,8,19,ITA,15,Campania,40.83956555,14.25084984,51,2,53,565,618,56,4345,440,5403,196936
3721,8,19,ITA,8,Emilia-Romagna,44.49436681,11.3417208,81,7,88,1707,1795,76,24324,4455,30574,467266
3722,8,19,ITA,6,Friuli Venezia Giulia,45.6494354,13.76813649,7,3,10,200,210,11,2975,348,3533,139117
3723,8,19,ITA,12,Lazio,41.89277044,12.48366722,229,6,235,1194,1429,75,6996,871,9296,382387
3724,8,19,ITA,7,Liguria,44.41149315,8.9326992,23,1,24,319,343,30,8619,1569,10531,115811
3725,8,19,ITA,3,Lombardia,45.46679409,9.190347404,151,14,165,5157,5322,91,75398,16844,97564,855372
3726,8,19,ITA,11,Marche,43.61675973,13.5188753,13,1,14,193,207,7,5871,987,7065,111360
3727,8,19,ITA,14,Molise,41.55774754,14.65916051,0,0,0,51,51,7,429,23,503,29270
3728,8,19,ITA,21,P.A. Bolzano,46.49933453,11.35662422,8,1,9,113,122,7,2397,292,2811,65438
3729,8,19,ITA,22,P.A. Trento,46.06893511,11.12123097,2,1,3,41,44,2,4559,405,5008,78156
3730,8,19,ITA,1,Piemonte,45.0732745,7.680687483,81,3,84,847,931,42,27096,4142,32169,330412
3731,8,19,ITA,16,Puglia,41.12559576,16.86736689,52,3,55,315,370,33,3990,555,4915,190197
3732,8,19,ITA,20,Sardegna,39.21531192,9.110616306,11,0,11,143,154,37,1261,134,1549,101544
3733,8,19,ITA,19,Sicilia,38.11569725,13.3623567,53,8,61,705,766,45,2786,286,3838,243575
3734,8,19,ITA,9,Toscana,43.76923077,11.25588885,20,5,25,721,746,40,9040,1139,10925,314078
3735,8,19,ITA,10,Umbria,43.10675841,12.38824698,9,2,11,84,95,4,1388,80,1563,85986
3736,8,19,ITA,2,Valle d'Aosta,45.73750286,7.320149366,1,0,1,9,10,2,1064,146,1220,16823
3737,8,19,ITA,5,Veneto,45.43490485,12.33845213,39,6,45,1616,1661,59,17615,2099,21375,546505
3738,8,20,ITA,13,Abruzzo,42.35122196,13.39843823,27,1,28,240,268,4,2841,472,3581,93423
3739,8,20,ITA,17,Basilicata,40.63947052,15.80514834,0,0,0,73,73,2,393,28,494,51168
3740,8,20,ITA,18,Calabria,38.90597598,16.59440194,11,1,12,139,151,10,1129,97,1377,139012
3741,8,20,ITA,15,Campania,40.83956555,14.25084984,56,2,58,613,671,53,4345,440,5456,198778
3742,8,20,ITA,8,Emilia-Romagna,44.49436681,11.3417208,77,8,85,1731,1816,52,24355,4455,30626,473891
3743,8,20,ITA,6,Friuli Venezia Giulia,45.6494354,13.76813649,9,3,12,210,222,14,2977,348,3547,140671
3744,8,20,ITA,12,Lazio,41.89277044,12.48366722,238,6,244,1296,1540,115,6999,872,9411,387285
3745,8,20,ITA,7,Liguria,44.41149315,8.9326992,21,1,22,333,355,31,8636,1571,10562,117149
3746,8,20,ITA,3,Lombardia,45.46679409,9.190347404,155,16,171,5252,5423,154,75449,16846,97718,864187
3747,8,20,ITA,11,Marche,43.61675973,13.5188753,14,1,15,202,217,13,5874,987,7078,112396
3748,8,20,ITA,14,Molise,41.55774754,14.65916051,1,0,1,54,55,4,429,23,507,29488
3749,8,20,ITA,21,P.A. Bolzano,46.49933453,11.35662422,8,1,9,130,139,21,2401,292,2832,66156
3750,8,20,ITA,22,P.A. Trento,46.06893511,11.12123097,2,1,3,41,44,4,4563,405,5012,78859
3751,8,20,ITA,1,Piemonte,45.0732745,7.680687483,83,3,86,891,977,52,27102,4142,32221,334082
3752,8,20,ITA,16,Puglia,41.12559576,16.86736689,58,3,61,328,389,20,3991,555,4935,192370
3753,8,20,ITA,20,Sardegna,39.21531192,9.110616306,12,0,12,159,171,23,1262,134,1567,102561
3754,8,20,ITA,19,Sicilia,38.11569725,13.3623567,41,8,49,741,790,37,2799,286,3875,245539
3755,8,20,ITA,9,Toscana,43.76923077,11.25588885,24,5,29,772,801,59,9044,1139,10984,317235
3756,8,20,ITA,10,Umbria,43.10675841,12.38824698,10,1,11,101,112,17,1388,80,1580,86741
3757,8,20,ITA,2,Valle d'Aosta,45.73750286,7.320149366,1,0,1,10,11,1,1064,146,1221,16893
3758,8,20,ITA,5,Veneto,45.43490485,12.33845213,35,7,42,1747,1789,159,17645,2100,21534,553065
3759,8,21,ITA,13,Abruzzo,42.35122196,13.39843823,30,1,31,258,289,23,2843,472,3604,94284
3760,8,21,ITA,17,Basilicata,40.63947052,15.80514834,0,0,0,63,63,0,403,28,494,51628
3761,8,21,ITA,18,Calabria,38.90597598,16.59440194,11,1,12,141,153,2,1129,97,1379,140352
3762,8,21,ITA,15,Campania,40.83956555,14.25084984,66,2,68,667,735,67,4348,440,5523,201641
3763,8,21,ITA,8,Emilia-Romagna,44.49436681,11.3417208,77,8,85,1776,1861,82,24392,4455,30708,478418
3764,8,21,ITA,6,Friuli Venezia Giulia,45.6494354,13.76813649,9,2,11,232,243,36,2992,348,3583,141840
3765,8,21,ITA,12,Lazio,41.89277044,12.48366722,248,6,254,1412,1666,137,7009,873,9548,392577
3766,8,21,ITA,7,Liguria,44.41149315,8.9326992,19,1,20,345,365,21,8647,1571,10583,118087
3767,8,21,ITA,3,Lombardia,45.46679409,9.190347404,149,17,166,5328,5494,174,75546,16852,97892,871210
3768,8,21,ITA,11,Marche,43.61675973,13.5188753,13,1,14,218,232,17,5876,987,7095,113688
3769,8,21,ITA,14,Molise,41.55774754,14.65916051,1,0,1,55,56,2,430,23,509,29696
3770,8,21,ITA,21,P.A. Bolzano,46.49933453,11.35662422,8,1,9,132,141,5,2404,292,2837,66986
3771,8,21,ITA,22,P.A. Trento,46.06893511,11.12123097,3,1,4,37,41,4,4570,405,5016,79214
3772,8,21,ITA,1,Piemonte,45.0732745,7.680687483,85,4,89,912,1001,39,27117,4142,32260,336656
3773,8,21,ITA,16,Puglia,41.12559576,16.86736689,61,4,65,354,419,35,3996,555,4970,194436
3774,8,21,ITA,20,Sardegna,39.21531192,9.110616306,13,0,13,200,213,42,1262,134,1609,103362
3775,8,21,ITA,19,Sicilia,38.11569725,13.3623567,45,8,53,775,828,44,2805,286,3919,247547
3776,8,21,ITA,9,Toscana,43.76923077,11.25588885,28,5,33,845,878,79,9046,1139,11063,320543
3777,8,21,ITA,10,Umbria,43.10675841,12.38824698,10,1,11,113,124,22,1398,80,1602,87468
3778,8,21,ITA,2,Valle d'Aosta,45.73750286,7.320149366,1,0,1,10,11,0,1064,146,1221,16942
3779,8,21,ITA,5,Veneto,45.43490485,12.33845213,42,6,48,1817,1865,116,17683,2102,21650,559317
3780,8,22,ITA,13,Abruzzo,42.35122196,13.39843823,32,1,33,280,313,24,2843,472,3628,95034
3781,8,22,ITA,17,Basilicata,40.63947052,15.80514834,0,0,0,66,66,3,403,28,497,52027
3782,8,22,ITA,18,Calabria,38.90597598,16.59440194,11,1,12,146,158,11,1135,97,1390,141694
3783,8,22,ITA,15,Campania,40.83956555,14.25084984,55,1,56,736,792,61,4352,440,5584,204634
3784,8,22,ITA,8,Emilia-Romagna,44.49436681,11.3417208,75,8,83,1842,1925,80,24408,4455,30788,483710
3785,8,22,ITA,6,Friuli Venezia Giulia,45.6494354,13.76813649,9,2,11,261,272,33,2996,348,3616,143300
3786,8,22,ITA,12,Lazio,41.89277044,12.48366722,265,6,271,1599,1870,215,7020,873,9763,397550
3787,8,22,ITA,7,Liguria,44.41149315,8.9326992,18,1,19,356,375,34,8671,1571,10617,119030
3788,8,22,ITA,3,Lombardia,45.46679409,9.190347404,148,14,162,5414,5576,185,75649,16852,98077,880198
3789,8,22,ITA,11,Marche,43.61675973,13.5188753,11,1,12,230,242,10,5876,987,7105,114764
3790,8,22,ITA,14,Molise,41.55774754,14.65916051,1,0,1,56,57,1,430,23,510,29986
3791,8,22,ITA,21,P.A. Bolzano,46.49933453,11.35662422,8,1,9,137,146,19,2418,292,2856,68151
3792,8,22,ITA,22,P.A. Trento,46.06893511,11.12123097,3,1,4,36,40,9,4580,405,5025,79771
3793,8,22,ITA,1,Piemonte,45.0732745,7.680687483,80,4,84,947,1031,41,27127,4143,32301,338684
3794,8,22,ITA,16,Puglia,41.12559576,16.86736689,62,4,66,370,436,22,4001,555,4992,196707
3795,8,22,ITA,20,Sardegna,39.21531192,9.110616306,14,0,14,243,257,44,1262,134,1653,104014
3796,8,22,ITA,19,Sicilia,38.11569725,13.3623567,45,8,53,821,874,48,2807,286,3967,249033
3797,8,22,ITA,9,Toscana,43.76923077,11.25588885,30,6,36,892,928,53,9049,1139,11116,323792
3798,8,22,ITA,10,Umbria,43.10675841,12.38824698,12,1,13,129,142,18,1398,80,1620,88187
3799,8,22,ITA,2,Valle d'Aosta,45.73750286,7.320149366,1,0,1,10,11,0,1064,146,1221,16988
3800,8,22,ITA,5,Veneto,45.43490485,12.33845213,44,4,48,1944,1992,160,17714,2104,21810,565251
3801,8,23,ITA,13,Abruzzo,42.35122196,13.39843823,31,1,32,300,332,21,2844,472,3648,95928
3802,8,23,ITA,17,Basilicata,40.63947052,15.80514834,1,0,1,70,71,5,403,28,502,52032
3803,8,23,ITA,18,Calabria,38.90597598,16.59440194,11,1,12,154,166,8,1135,97,1398,142878
3804,8,23,ITA,15,Campania,40.83956555,14.25084984,61,2,63,862,925,138,4356,441,5722,208401
3805,8,23,ITA,8,Emilia-Romagna,44.49436681,11.3417208,77,8,85,1949,2034,127,24425,4456,30915,488330
3806,8,23,ITA,6,Friuli Venezia Giulia,45.6494354,13.76813649,10,2,12,279,291,24,3001,348,3640,144651
3807,8,23,ITA,12,Lazio,41.89277044,12.48366722,286,6,292,1735,2027,184,7046,874,9947,404727
3808,8,23,ITA,7,Liguria,44.41149315,8.9326992,18,1,19,379,398,28,8676,1571,10645,119961
3809,8,23,ITA,3,Lombardia,45.46679409,9.190347404,148,14,162,5620,5782,239,75678,16856,98316,890586
3810,8,23,ITA,11,Marche,43.61675973,13.5188753,12,1,13,232,245,5,5878,987,7110,115806
3811,8,23,ITA,14,Molise,41.55774754,14.65916051,1,0,1,57,58,1,430,23,511,30064
3812,8,23,ITA,21,P.A. Bolzano,46.49933453,11.35662422,8,1,9,148,157,13,2420,292,2869,68769
3813,8,23,ITA,22,P.A. Trento,46.06893511,11.12123097,3,1,4,39,43,3,4580,405,5028,80296
3814,8,23,ITA,1,Piemonte,45.0732745,7.680687483,78,5,83,978,1061,42,27139,4143,32343,341447
3815,8,23,ITA,16,Puglia,41.12559576,16.86736689,68,4,72,395,467,33,4003,555,5025,198019
3816,8,23,ITA,20,Sardegna,39.21531192,9.110616306,18,0,18,320,338,81,1262,134,1734,104930
3817,8,23,ITA,19,Sicilia,38.11569725,13.3623567,50,10,60,843,903,35,2813,286,4002,250646
3818,8,23,ITA,9,Toscana,43.76923077,11.25588885,35,7,42,938,980,59,9056,1139,11175,326623
3819,8,23,ITA,10,Umbria,43.10675841,12.38824698,11,1,12,148,160,19,1399,80,1639,88882
3820,8,23,ITA,2,Valle d'Aosta,45.73750286,7.320149366,1,0,1,10,11,0,1064,146,1221,17117
3821,8,23,ITA,5,Veneto,45.43490485,12.33845213,43,4,47,1942,1989,145,17862,2104,21955,569875
3822,8,24,ITA,13,Abruzzo,42.35122196,13.39843823,34,1,35,301,336,4,2844,472,3652,96085
3823,8,24,ITA,17,Basilicata,40.63947052,15.80514834,2,0,2,68,70,0,404,28,502,52310
3824,8,24,ITA,18,Calabria,38.90597598,16.59440194,13,1,14,153,167,2,1136,97,1400,144148
3825,8,24,ITA,15,Campania,40.83956555,14.25084984,72,2,74,967,1041,116,4356,441,5838,211095
3826,8,24,ITA,8,Emilia-Romagna,44.49436681,11.3417208,82,8,90,2049,2139,116,24434,4458,31031,491660
3827,8,24,ITA,6,Friuli Venezia Giulia,45.6494354,13.76813649,11,2,13,278,291,2,3003,348,3642,145196
3828,8,24,ITA,12,Lazio,41.89277044,12.48366722,299,6,305,1846,2151,146,7067,875,10093,409290
3829,8,24,ITA,7,Liguria,44.41149315,8.9326992,22,0,22,379,401,26,8699,1571,10671,120593
3830,8,24,ITA,3,Lombardia,45.46679409,9.190347404,153,15,168,5696,5864,110,75705,16857,98426,896473
3831,8,24,ITA,11,Marche,43.61675973,13.5188753,13,0,13,230,243,3,5883,987,7113,116228
3832,8,24,ITA,14,Molise,41.55774754,14.65916051,2,0,2,54,56,0,432,23,511,30213
3833,8,24,ITA,21,P.A. Bolzano,46.49933453,11.35662422,8,1,9,163,172,15,2420,292,2884,69119
3834,8,24,ITA,22,P.A. Trento,46.06893511,11.12123097,3,1,4,40,44,1,4580,405,5029,80388
3835,8,24,ITA,1,Piemonte,45.0732745,7.680687483,83,5,88,1007,1095,40,27145,4143,32383,342897
3836,8,24,ITA,16,Puglia,41.12559576,16.86736689,81,4,85,420,505,45,4010,555,5070,199575
3837,8,24,ITA,20,Sardegna,39.21531192,9.110616306,18,0,18,411,429,91,1262,134,1825,105849
3838,8,24,ITA,19,Sicilia,38.11569725,13.3623567,54,9,63,884,947,65,2834,286,4067,251757
3839,8,24,ITA,9,Toscana,43.76923077,11.25588885,39,5,44,971,1015,44,9065,1139,11219,328743
3840,8,24,ITA,10,Umbria,43.10675841,12.38824698,12,1,13,157,170,11,1400,80,1650,89426
3841,8,24,ITA,2,Valle d'Aosta,45.73750286,7.320149366,1,0,1,10,11,0,1064,146,1221,17141
3842,8,24,ITA,5,Veneto,45.43490485,12.33845213,43,4,47,2001,2048,116,17919,2104,22071,575140
3843,8,25,ITA,13,Abruzzo,42.35122196,13.39843823,33,1,34,308,342,10,2848,472,3662,96605
3844,8,25,ITA,17,Basilicata,40.63947052,15.80514834,2,0,2,71,73,3,404,28,505,52812
3845,8,25,ITA,18,Calabria,38.90597598,16.59440194,14,1,15,155,170,8,1141,97,1408,145610
3846,8,25,ITA,15,Campania,40.83956555,14.25084984,76,3,79,1085,1164,138,4370,442,5976,214193
3847,8,25,ITA,8,Emilia-Romagna,44.49436681,11.3417208,90,5,95,2094,2189,65,24447,4458,31094,496062
3848,8,25,ITA,6,Friuli Venezia Giulia,45.6494354,13.76813649,13,2,15,283,298,9,3005,348,3651,145371
3849,8,25,ITA,12,Lazio,41.89277044,12.48366722,281,6,287,1997,2284,143,7077,875,10236,417490
3850,8,25,ITA,7,Liguria,44.41149315,8.9326992,24,0,24,389,413,12,8699,1571,10683,121487
3851,8,25,ITA,3,Lombardia,45.46679409,9.190347404,158,15,173,5614,5787,119,75901,16857,98545,903586
3852,8,25,ITA,11,Marche,43.61675973,13.5188753,14,0,14,234,248,11,5889,987,7124,117078
3853,8,25,ITA,14,Molise,41.55774754,14.65916051,2,0,2,54,56,0,432,23,511,30317
3854,8,25,ITA,21,P.A. Bolzano,46.49933453,11.35662422,8,1,9,168,177,9,2424,292,2893,69465
3855,8,25,ITA,22,P.A. Trento,46.06893511,11.12123097,4,1,5,42,47,3,4580,405,5032,80672
3856,8,25,ITA,1,Piemonte,45.0732745,7.680687483,79,6,85,1057,1142,57,27155,4143,32440,344929
3857,8,25,ITA,16,Puglia,41.12559576,16.86736689,88,4,92,456,548,49,4016,555,5119,202052
3858,8,25,ITA,20,Sardegna,39.21531192,9.110616306,19,0,19,444,463,34,1262,134,1859,107288
3859,8,25,ITA,19,Sicilia,38.11569725,13.3623567,53,10,63,884,947,24,2858,286,4091,253585
3860,8,25,ITA,9,Toscana,43.76923077,11.25588885,41,5,46,993,1039,34,9075,1139,11253,331202
3861,8,25,ITA,10,Umbria,43.10675841,12.38824698,12,1,13,182,195,29,1404,80,1679,90382
3862,8,25,ITA,2,Valle d'Aosta,45.73750286,7.320149366,1,0,1,12,13,2,1064,146,1223,17211
3863,8,25,ITA,5,Veneto,45.43490485,12.33845213,46,5,51,2068,2119,119,17964,2107,22190,581727
3864,8,26,ITA,13,Abruzzo,42.35122196,13.39843823,34,1,35,331,366,26,2849,472,3687,97421
3865,8,26,ITA,17,Basilicata,40.63947052,15.80514834,2,0,2,72,74,3,406,28,508,53350
3866,8,26,ITA,18,Calabria,38.90597598,16.59440194,14,0,14,159,173,8,1146,97,1416,146834
3867,8,26,ITA,15,Campania,40.83956555,14.25084984,75,3,78,1217,1295,135,4373,443,6111,216836
3868,8,26,ITA,8,Emilia-Romagna,44.49436681,11.3417208,92,6,98,2203,2301,120,24455,4458,31214,501373
3869,8,26,ITA,6,Friuli Venezia Giulia,45.6494354,13.76813649,14,0,14,307,321,33,3015,348,3684,147690
3870,8,26,ITA,12,Lazio,41.89277044,12.48366722,263,6,269,2143,2412,162,7110,876,10398,424488
3871,8,26,ITA,7,Liguria,44.41149315,8.9326992,23,0,23,417,440,41,8713,1571,10724,122720
3872,8,26,ITA,3,Lombardia,45.46679409,9.190347404,158,17,175,5794,5969,269,75988,16857,98814,915651
3873,8,26,ITA,11,Marche,43.61675973,13.5188753,9,0,9,232,241,9,5905,987,7133,117791
3874,8,26,ITA,14,Molise,41.55774754,14.65916051,3,0,3,62,65,9,432,23,520,30659
3875,8,26,ITA,21,P.A. Bolzano,46.49933453,11.35662422,8,1,9,169,178,5,2428,292,2898,70275
3876,8,26,ITA,22,P.A. Trento,46.06893511,11.12123097,4,1,5,42,47,7,4587,405,5039,81224
3877,8,26,ITA,1,Piemonte,45.0732745,7.680687483,83,6,89,1119,1208,75,27163,4144,32515,348648
3878,8,26,ITA,16,Puglia,41.12559576,16.86736689,94,4,98,499,597,51,4018,555,5170,204620
3879,8,26,ITA,20,Sardegna,39.21531192,9.110616306,20,1,21,492,513,53,1265,134,1912,108703
3880,8,26,ITA,19,Sicilia,38.11569725,13.3623567,59,10,69,911,980,33,2858,286,4124,256456
3881,8,26,ITA,9,Toscana,43.76923077,11.25588885,43,6,49,1142,1191,161,9083,1140,11414,335476
3882,8,26,ITA,10,Umbria,43.10675841,12.38824698,11,1,12,200,212,20,1407,80,1699,91421
3883,8,26,ITA,2,Valle d'Aosta,45.73750286,7.320149366,0,0,0,12,12,0,1065,146,1223,17328
3884,8,26,ITA,5,Veneto,45.43490485,12.33845213,46,6,52,2106,2158,147,18063,2116,22337,588214
3885,8,27,ITA,13,Abruzzo,42.35122196,13.39843823,37,1,38,343,381,18,2852,472,3705,98466
3886,8,27,ITA,17,Basilicata,40.63947052,15.80514834,2,0,2,78,80,6,406,28,514,53905
3887,8,27,ITA,18,Calabria,38.90597598,16.59440194,14,0,14,165,179,6,1146,97,1422,148438
3888,8,27,ITA,15,Campania,40.83956555,14.25084984,108,4,112,1311,1423,130,4373,445,6241,219960
3889,8,27,ITA,8,Emilia-Romagna,44.49436681,11.3417208,93,8,101,2366,2467,171,24460,4458,31385,506243
3890,8,27,ITA,6,Friuli Venezia Giulia,45.6494354,13.76813649,13,0,13,322,335,25,3026,348,3709,149088
3891,8,27,ITA,12,Lazio,41.89277044,12.48366722,268,6,274,2281,2555,152,7118,877,10550,431825
3892,8,27,ITA,7,Liguria,44.41149315,8.9326992,26,0,26,432,458,37,8732,1571,10761,123950
3893,8,27,ITA,3,Lombardia,45.46679409,9.190347404,173,14,187,6038,6225,286,76018,16857,99100,929040
3894,8,27,ITA,11,Marche,43.61675973,13.5188753,8,0,8,275,283,61,5924,987,7194,118825
3895,8,27,ITA,14,Molise,41.55774754,14.65916051,3,0,3,63,66,1,432,23,521,31234
3896,8,27,ITA,21,P.A. Bolzano,46.49933453,11.35662422,8,1,9,176,185,9,2430,292,2907,70742
3897,8,27,ITA,22,P.A. Trento,46.06893511,11.12123097,4,1,5,56,61,15,4588,405,5054,81734
3898,8,27,ITA,1,Piemonte,45.0732745,7.680687483,78,6,84,1197,1281,88,27178,4144,32603,351842
3899,8,27,ITA,16,Puglia,41.12559576,16.86736689,97,3,100,537,637,47,4024,556,5217,207094
3900,8,27,ITA,20,Sardegna,39.21531192,9.110616306,24,2,26,542,568,57,1265,134,1967,110167
3901,8,27,ITA,19,Sicilia,38.11569725,13.3623567,62,10,72,947,1019,50,2869,286,4174,259530
3902,8,27,ITA,9,Toscana,43.76923077,11.25588885,43,5,48,1225,1273,99,9100,1140,11513,339644
3903,8,27,ITA,10,Umbria,43.10675841,12.38824698,12,1,13,209,222,20,1417,80,1719,92218
3904,8,27,ITA,2,Valle d'Aosta,45.73750286,7.320149366,0,0,0,13,13,1,1065,146,1224,17385
3905,8,27,ITA,5,Veneto,45.43490485,12.33845213,58,5,63,2158,2221,132,18131,2117,22469,593488
3906,8,28,ITA,13,Abruzzo,42.35122196,13.39843823,39,1,40,343,383,20,2870,472,3725,99372
3907,8,28,ITA,17,Basilicata,40.63947052,15.80514834,1,1,2,81,83,4,407,28,518,54518
3908,8,28,ITA,18,Calabria,38.90597598,16.59440194,14,0,14,175,189,10,1146,97,1432,149976
3909,8,28,ITA,15,Campania,40.83956555,14.25084984,121,5,126,1470,1596,183,4383,445,6424,224127
3910,8,28,ITA,8,Emilia-Romagna,44.49436681,11.3417208,94,9,103,2518,2621,164,24467,4459,31547,513131
3911,8,28,ITA,6,Friuli Venezia Giulia,45.6494354,13.76813649,13,0,13,334,347,19,3033,348,3728,149961
3912,8,28,ITA,12,Lazio,41.89277044,12.48366722,283,6,289,2427,2716,166,7122,878,10716,444539
3913,8,28,ITA,7,Liguria,44.41149315,8.9326992,28,0,28,441,469,46,8767,1571,10807,125061
3914,8,28,ITA,3,Lombardia,45.46679409,9.190347404,172,17,189,6265,6454,316,76102,16860,99416,943463
3915,8,28,ITA,11,Marche,43.61675973,13.5188753,8,1,9,282,291,17,5933,987,7211,119608
3916,8,28,ITA,14,Molise,41.55774754,14.65916051,3,0,3,64,67,1,432,23,522,31696
3917,8,28,ITA,21,P.A. Bolzano,46.49933453,11.35662422,8,1,9,180,189,8,2434,292,2915,71480
3918,8,28,ITA,22,P.A. Trento,46.06893511,11.12123097,6,1,7,67,74,16,4591,405,5070,82117
3919,8,28,ITA,1,Piemonte,45.0732745,7.680687483,82,6,88,1258,1346,91,27203,4145,32694,354777
3920,8,28,ITA,16,Puglia,41.12559576,16.86736689,104,5,109,575,684,51,4028,556,5268,209467
3921,8,28,ITA,20,Sardegna,39.21531192,9.110616306,23,2,25,597,622,55,1266,134,2022,111549
3922,8,28,ITA,19,Sicilia,38.11569725,13.3623567,69,9,78,980,1058,54,2884,286,4228,261940
3923,8,28,ITA,9,Toscana,43.76923077,11.25588885,47,4,51,1298,1349,82,9105,1141,11595,343913
3924,8,28,ITA,10,Umbria,43.10675841,12.38824698,12,0,12,217,229,22,1432,80,1741,93480
3925,8,28,ITA,2,Valle d'Aosta,45.73750286,7.320149366,1,0,1,14,15,2,1065,146,1226,17429
3926,8,28,ITA,5,Veneto,45.43490485,12.33845213,50,6,56,2197,2253,135,18232,2119,22604,598349
3927,8,29,ITA,13,Abruzzo,42.35122196,13.39843823,37,1,38,357,395,14,2872,472,3739,100339
3928,8,29,ITA,17,Basilicata,40.63947052,15.80514834,1,1,2,85,87,5,408,28,523,55210
3929,8,29,ITA,18,Calabria,38.90597598,16.59440194,17,0,17,181,198,11,1148,97,1443,151506
3930,8,29,ITA,15,Campania,40.83956555,14.25084984,72,2,74,1697,1771,188,4396,445,6612,227878
3931,8,29,ITA,8,Emilia-Romagna,44.49436681,11.3417208,98,10,108,2661,2769,149,24468,4459,31696,519748
3932,8,29,ITA,6,Friuli Venezia Giulia,45.6494354,13.76813649,15,0,15,333,348,20,3052,348,3748,151497
3933,8,29,ITA,12,Lazio,41.89277044,12.48366722,293,8,301,2581,2882,171,7127,878,10887,455146
3934,8,29,ITA,7,Liguria,44.41149315,8.9326992,29,1,30,463,493,47,8790,1571,10854,126071
3935,8,29,ITA,3,Lombardia,45.46679409,9.190347404,185,18,203,6442,6645,289,76200,16860,99705,957455
3936,8,29,ITA,11,Marche,43.61675973,13.5188753,10,1,11,285,296,12,5940,987,7223,120551
3937,8,29,ITA,14,Molise,41.55774754,14.65916051,3,0,3,66,69,2,432,23,524,31853
3938,8,29,ITA,21,P.A. Bolzano,46.49933453,11.35662422,8,2,10,180,190,9,2442,292,2924,72200
3939,8,29,ITA,22,P.A. Trento,46.06893511,11.12123097,3,1,4,80,84,14,4595,405,5084,82538
3940,8,29,ITA,1,Piemonte,45.0732745,7.680687483,81,5,86,1297,1383,90,27256,4145,32784,357323
3941,8,29,ITA,16,Puglia,41.12559576,16.86736689,112,5,117,631,748,65,4029,556,5333,212037
3942,8,29,ITA,20,Sardegna,39.21531192,9.110616306,24,2,26,665,691,70,1267,134,2092,113122
3943,8,29,ITA,19,Sicilia,38.11569725,13.3623567,70,10,80,1004,1084,29,2887,286,4257,264227
3944,8,29,ITA,9,Toscana,43.76923077,11.25588885,44,5,49,1372,1421,92,9125,1141,11687,348617
3945,8,29,ITA,10,Umbria,43.10675841,12.38824698,11,1,12,226,238,12,1435,80,1753,94548
3946,8,29,ITA,2,Valle d'Aosta,45.73750286,7.320149366,1,0,1,18,19,4,1065,146,1230,17463
3947,8,29,ITA,5,Veneto,45.43490485,12.33845213,54,6,60,2285,2345,151,18290,2120,22755,604918
3948,8,30,ITA,13,Abruzzo,42.35122196,13.39843823,37,1,38,391,429,34,2872,472,3773,101829
3949,8,30,ITA,17,Basilicata,40.63947052,15.80514834,1,1,2,86,88,1,408,28,524,55211
3950,8,30,ITA,18,Calabria,38.90597598,16.59440194,17,0,17,215,232,34,1148,97,1477,152885
3951,8,30,ITA,15,Campania,40.83956555,14.25084984,110,4,114,1911,2025,270,4412,445,6882,233301
3952,8,30,ITA,8,Emilia-Romagna,44.49436681,11.3417208,99,11,110,2758,2868,109,24478,4459,31805,524656
3953,8,30,ITA,6,Friuli Venezia Giulia,45.6494354,13.76813649,15,1,16,344,360,16,3056,348,3764,152158
3954,8,30,ITA,12,Lazio,41.89277044,12.48366722,310,7,317,2718,3035,156,7130,878,11043,466475
3955,8,30,ITA,7,Liguria,44.41149315,8.9326992,32,1,33,476,509,53,8827,1571,10907,127057
3956,8,30,ITA,3,Lombardia,45.46679409,9.190347404,194,20,214,6615,6829,235,76248,16863,99940,966973
3957,8,30,ITA,11,Marche,43.61675973,13.5188753,12,1,13,289,302,15,5949,987,7238,121344
3958,8,30,ITA,14,Molise,41.55774754,14.65916051,3,0,3,67,70,1,432,23,525,32155
3959,8,30,ITA,21,P.A. Bolzano,46.49933453,11.35662422,8,2,10,180,190,8,2450,292,2932,72684
3960,8,30,ITA,22,P.A. Trento,46.06893511,11.12123097,3,1,4,83,87,8,4600,405,5092,82952
3961,8,30,ITA,1,Piemonte,45.0732745,7.680687483,85,5,90,1315,1405,60,27293,4146,32844,359814
3962,8,30,ITA,16,Puglia,41.12559576,16.86736689,117,5,122,695,817,69,4029,556,5402,213959
3963,8,30,ITA,20,Sardegna,39.21531192,9.110616306,28,3,31,681,712,22,1268,134,2114,114114
3964,8,30,ITA,19,Sicilia,38.11569725,13.3623567,68,10,78,1036,1114,34,2891,286,4291,266061
3965,8,30,ITA,9,Toscana,43.76923077,11.25588885,48,5,53,1450,1503,98,9141,1141,11785,353231
3966,8,30,ITA,10,Umbria,43.10675841,12.38824698,10,1,11,251,262,31,1442,80,1784,95419
3967,8,30,ITA,2,Valle d'Aosta,45.73750286,7.320149366,2,0,2,21,23,2,1063,146,1232,17533
3968,8,30,ITA,5,Veneto,45.43490485,12.33845213,52,7,59,2286,2345,109,18399,2120,22864,607977
3969,8,31,ITA,13,Abruzzo,42.35122196,13.39843823,35,1,36,391,427,4,2878,472,3777,101993
3970,8,31,ITA,17,Basilicata,40.63947052,15.80514834,1,1,2,86,88,0,408,28,524,55487
3971,8,31,ITA,18,Calabria,38.90597598,16.59440194,21,0,21,224,245,14,1149,97,1491,153811
3972,8,31,ITA,15,Campania,40.83956555,14.25084984,95,1,96,2114,2210,184,4411,445,7066,237519
3973,8,31,ITA,8,Emilia-Romagna,44.49436681,11.3417208,106,9,115,2862,2977,117,24482,4463,31922,528294
3974,8,31,ITA,6,Friuli Venezia Giulia,45.6494354,13.76813649,13,2,15,350,365,5,3056,348,3769,152510
3975,8,31,ITA,12,Lazio,41.89277044,12.48366722,328,7,335,2839,3174,148,7139,878,11191,477920
3976,8,31,ITA,7,Liguria,44.41149315,8.9326992,38,1,39,502,541,44,8839,1571,10951,128050
3977,8,31,ITA,3,Lombardia,45.46679409,9.190347404,195,22,217,6735,6952,135,76258,16865,100075,974484
3978,8,31,ITA,11,Marche,43.61675973,13.5188753,13,1,14,284,298,2,5955,987,7240,121684
3979,8,31,ITA,14,Molise,41.55774754,14.65916051,3,0,3,67,70,0,432,23,525,32364
3980,8,31,ITA,21,P.A. Bolzano,46.49933453,11.35662422,8,2,10,180,190,3,2453,292,2935,73091
3981,8,31,ITA,22,P.A. Trento,46.06893511,11.12123097,5,1,6,85,91,4,4600,405,5096,83022
3982,8,31,ITA,1,Piemonte,45.0732745,7.680687483,98,7,105,1327,1432,37,27303,4146,32881,360988
3983,8,31,ITA,16,Puglia,41.12559576,16.86736689,116,7,123,721,844,38,4040,556,5440,216105
3984,8,31,ITA,20,Sardegna,39.21531192,9.110616306,28,4,32,757,789,79,1270,134,2193,115112
3985,8,31,ITA,19,Sicilia,38.11569725,13.3623567,70,10,80,1045,1125,26,2906,286,4317,267086
3986,8,31,ITA,9,Toscana,43.76923077,11.25588885,52,8,60,1514,1574,73,9143,1141,11858,356542
3987,8,31,ITA,10,Umbria,43.10675841,12.38824698,10,2,12,256,268,9,1445,80,1793,95705
3988,8,31,ITA,2,Valle d'Aosta,45.73750286,7.320149366,2,0,2,29,31,9,1064,146,1241,17602
3989,8,31,ITA,5,Veneto,45.43490485,12.33845213,51,8,59,2328,2387,65,18422,2120,22929,611002
3990,9,1,ITA,13,Abruzzo,42.35122196,13.39843823,29,1,30,376,406,5,2902,472,3780,102588
3991,9,1,ITA,17,Basilicata,40.63947052,15.80514834,1,1,2,86,88,1,408,28,524,55949
3992,9,1,ITA,18,Calabria,38.90597598,16.59440194,22,0,22,244,266,22,1150,97,1513,155296
3993,9,1,ITA,15,Campania,40.83956555,14.25084984,143,6,149,2143,2292,102,4430,446,7168,242683
3994,9,1,ITA,8,Emilia-Romagna,44.49436681,11.3417208,106,9,115,2946,3061,99,24497,4463,32021,533273
3995,9,1,ITA,6,Friuli Venezia Giulia,45.6494354,13.76813649,12,2,14,363,377,17,3061,348,3786,153624
3996,9,1,ITA,12,Lazio,41.89277044,12.48366722,336,8,344,2941,3285,125,7153,878,11316,486744
3997,9,1,ITA,7,Liguria,44.41149315,8.9326992,39,5,44,516,560,19,8839,1571,10970,128951
3998,9,1,ITA,3,Lombardia,45.46679409,9.190347404,212,21,233,6849,7082,242,76368,16867,100317,986403
3999,9,1,ITA,11,Marche,43.61675973,13.5188753,14,1,15,294,309,16,5960,987,7256,122724
4000,9,1,ITA,14,Molise,41.55774754,14.65916051,3,0,3,70,73,3,432,23,528,32507
4001,9,1,ITA,21,P.A. Bolzano,46.49933453,11.35662422,8,2,10,191,201,13,2455,292,2948,73432
4002,9,1,ITA,22,P.A. Trento,46.06893511,11.12123097,4,1,5,87,92,3,4602,405,5099,83419
4003,9,1,ITA,1,Piemonte,45.0732745,7.680687483,92,7,99,1365,1464,42,27313,4146,32923,363196
4004,9,1,ITA,16,Puglia,41.12559576,16.86736689,123,7,130,730,860,39,4062,557,5479,218643
4005,9,1,ITA,20,Sardegna,39.21531192,9.110616306,31,6,37,800,837,50,1272,134,2243,116718
4006,9,1,ITA,19,Sicilia,38.11569725,13.3623567,71,10,81,1071,1152,33,2911,287,4350,269806
4007,9,1,ITA,9,Toscana,43.76923077,11.25588885,53,9,62,1519,1581,40,9175,1142,11898,360022
4008,9,1,ITA,10,Umbria,43.10675841,12.38824698,9,2,11,267,278,10,1445,80,1803,96713
4009,9,1,ITA,2,Valle d'Aosta,45.73750286,7.320149366,3,0,3,27,30,0,1065,146,1241,17699
4010,9,1,ITA,5,Veneto,45.43490485,12.33845213,69,9,78,2382,2460,97,18444,2122,23026,614376
4011,9,2,ITA,13,Abruzzo,42.35122196,13.39843823,30,1,31,399,430,24,2902,472,3804,103603
4012,9,2,ITA,17,Basilicata,40.63947052,15.80514834,1,1,2,88,90,2,408,28,526,56534
4013,9,2,ITA,18,Calabria,38.90597598,16.59440194,21,0,21,269,290,32,1158,97,1545,157068
4014,9,2,ITA,15,Campania,40.83956555,14.25084984,163,4,167,2235,2402,117,4437,446,7285,247341
4015,9,2,ITA,8,Emilia-Romagna,44.49436681,11.3417208,104,10,114,2989,3103,107,24562,4463,32128,540012
4016,9,2,ITA,6,Friuli Venezia Giulia,45.6494354,13.76813649,11,3,14,373,387,20,3070,349,3806,154882
4017,9,2,ITA,12,Lazio,41.89277044,12.48366722,343,9,352,3055,3407,130,7161,878,11446,495791
4018,9,2,ITA,7,Liguria,44.41149315,8.9326992,38,6,44,563,607,47,8839,1571,11017,130214
4019,9,2,ITA,3,Lombardia,45.46679409,9.190347404,220,22,242,7036,7278,237,76407,16869,100554,998868
4020,9,2,ITA,11,Marche,43.61675973,13.5188753,14,1,15,305,320,17,5966,987,7273,123648
4021,9,2,ITA,14,Molise,41.55774754,14.65916051,3,0,3,70,73,0,432,23,528,32812
4022,9,2,ITA,21,P.A. Bolzano,46.49933453,11.35662422,8,2,10,196,206,10,2460,292,2958,74019
4023,9,2,ITA,22,P.A. Trento,46.06893511,11.12123097,4,1,5,118,123,33,4604,405,5132,83762
4024,9,2,ITA,1,Piemonte,45.0732745,7.680687483,90,7,97,1424,1521,66,27321,4147,32989,366797
4025,9,2,ITA,16,Puglia,41.12559576,16.86736689,140,6,146,776,922,67,4067,557,5546,221391
4026,9,2,ITA,20,Sardegna,39.21531192,9.110616306,32,5,37,872,909,73,1272,135,2316,118433
4027,9,2,ITA,19,Sicilia,38.11569725,13.3623567,76,12,88,1139,1227,83,2919,287,4433,272775
4028,9,2,ITA,9,Toscana,43.76923077,11.25588885,58,8,66,1570,1636,69,9189,1142,11967,365415
4029,9,2,ITA,10,Umbria,43.10675841,12.38824698,8,2,10,288,298,27,1452,80,1830,97623
4030,9,2,ITA,2,Valle d'Aosta,45.73750286,7.320149366,3,0,3,29,32,2,1065,146,1243,17785
4031,9,2,ITA,5,Veneto,45.43490485,12.33845213,70,9,79,2477,2556,163,18510,2123,23189,622175
4032,9,3,ITA,13,Abruzzo,42.35122196,13.39843823,33,1,34,420,454,24,2902,472,3828,104572
4033,9,3,ITA,17,Basilicata,40.63947052,15.80514834,2,1,3,102,105,15,408,28,541,57240
4034,9,3,ITA,18,Calabria,38.90597598,16.59440194,20,1,21,273,294,13,1167,97,1558,158698
4035,9,3,ITA,15,Campania,40.83956555,14.25084984,185,4,189,2391,2580,193,4452,446,7478,252337
4036,9,3,ITA,8,Emilia-Romagna,44.49436681,11.3417208,108,11,119,3066,3185,118,24598,4463,32246,546180
4037,9,3,ITA,6,Friuli Venezia Giulia,45.6494354,13.76813649,12,3,15,387,402,25,3080,349,3831,155933
4038,9,3,ITA,12,Lazio,41.89277044,12.48366722,351,9,360,3184,3544,154,7177,879,11600,506670
4039,9,3,ITA,7,Liguria,44.41149315,8.9326992,39,7,46,581,627,22,8840,1572,11039,131659
4040,9,3,ITA,3,Lombardia,45.46679409,9.190347404,225,27,252,7193,7445,228,76467,16870,100782,1008369
4041,9,3,ITA,11,Marche,43.61675973,13.5188753,13,1,14,321,335,21,5971,988,7294,124694
4042,9,3,ITA,14,Molise,41.55774754,14.65916051,3,0,3,72,75,2,432,23,530,33143
4043,9,3,ITA,21,P.A. Bolzano,46.49933453,11.35662422,8,2,10,196,206,4,2464,292,2962,74513
4044,9,3,ITA,22,P.A. Trento,46.06893511,11.12123097,3,1,4,206,210,91,4608,405,5223,84365
4045,9,3,ITA,1,Piemonte,45.0732745,7.680687483,92,7,99,1487,1586,75,27330,4148,33064,369467
4046,9,3,ITA,16,Puglia,41.12559576,16.86736689,148,6,154,832,986,78,4078,560,5624,224094
4047,9,3,ITA,20,Sardegna,39.21531192,9.110616306,35,6,41,905,946,39,1274,135,2355,120029
4048,9,3,ITA,19,Sicilia,38.11569725,13.3623567,81,12,93,1159,1252,54,2947,288,4487,275130
4049,9,3,ITA,9,Toscana,43.76923077,11.25588885,63,7,70,1661,1731,113,9206,1143,12080,371628
4050,9,3,ITA,10,Umbria,43.10675841,12.38824698,10,2,12,290,302,9,1457,80,1839,98418
4051,9,3,ITA,2,Valle d'Aosta,45.73750286,7.320149366,3,0,3,33,36,4,1065,146,1247,17863
4052,9,3,ITA,5,Veneto,45.43490485,12.33845213,71,12,83,2531,2614,115,18567,2123,23304,627148
4053,9,4,ITA,13,Abruzzo,42.35122196,13.39843823,32,1,33,438,471,25,2910,472,3853,105546
4054,9,4,ITA,17,Basilicata,40.63947052,15.80514834,3,1,4,104,108,7,412,28,548,57880
4055,9,4,ITA,18,Calabria,38.90597598,16.59440194,19,1,20,293,313,19,1167,97,1577,160382
4056,9,4,ITA,15,Campania,40.83956555,14.25084984,196,5,201,2530,2731,171,4471,447,7649,257337
4057,9,4,ITA,8,Emilia-Romagna,44.49436681,11.3417208,114,13,127,3062,3189,126,24719,4463,32371,551727
4058,9,4,ITA,6,Friuli Venezia Giulia,45.6494354,13.76813649,11,4,15,397,412,23,3093,349,3854,156816
4059,9,4,ITA,12,Lazio,41.89277044,12.48366722,363,9,372,3316,3688,171,7204,879,11771,517073
4060,9,4,ITA,7,Liguria,44.41149315,8.9326992,48,6,54,619,673,47,8841,1572,11086,132733
4061,9,4,ITA,3,Lombardia,45.46679409,9.190347404,244,26,270,7399,7669,337,76574,16876,101119,1028404
4062,9,4,ITA,11,Marche,43.61675973,13.5188753,12,1,13,328,341,17,5982,988,7311,125411
4063,9,4,ITA,14,Molise,41.55774754,14.65916051,3,0,3,75,78,4,433,23,534,33340
4064,9,4,ITA,21,P.A. Bolzano,46.49933453,11.35662422,8,2,10,199,209,11,2472,292,2973,74949
4065,9,4,ITA,22,P.A. Trento,46.06893511,11.12123097,7,0,7,223,230,23,4611,405,5246,84881
4066,9,4,ITA,1,Piemonte,45.0732745,7.680687483,110,7,117,1531,1648,82,27349,4149,33146,372210
4067,9,4,ITA,16,Puglia,41.12559576,16.86736689,150,7,157,929,1086,117,4095,560,5741,226927
4068,9,4,ITA,20,Sardegna,39.21531192,9.110616306,41,6,47,963,1010,66,1276,135,2421,121848
4069,9,4,ITA,19,Sicilia,38.11569725,13.3623567,87,11,98,1186,1284,78,2993,288,4565,277515
4070,9,4,ITA,9,Toscana,43.76923077,11.25588885,67,8,75,1742,1817,99,9219,1143,12179,377468
4071,9,4,ITA,10,Umbria,43.10675841,12.38824698,11,3,14,313,327,35,1467,80,1874,99741
4072,9,4,ITA,2,Valle d'Aosta,45.73750286,7.320149366,2,0,2,33,35,2,1068,146,1249,17904
4073,9,4,ITA,5,Veneto,45.43490485,12.33845213,79,10,89,2691,2780,273,18671,2126,23577,634616
4074,9,5,ITA,13,Abruzzo,42.35122196,13.39843823,32,2,34,449,483,13,2910,472,3865,106544
4075,9,5,ITA,17,Basilicata,40.63947052,15.80514834,3,1,4,111,115,7,412,28,555,58544
4076,9,5,ITA,18,Calabria,38.90597598,16.59440194,20,0,20,305,325,19,1173,98,1596,162336
4077,9,5,ITA,15,Campania,40.83956555,14.25084984,207,6,213,2631,2844,119,4476,448,7768,263202
4078,9,5,ITA,8,Emilia-Romagna,44.49436681,11.3417208,122,12,134,3117,3251,133,24790,4463,32504,556876
4079,9,5,ITA,6,Friuli Venezia Giulia,45.6494354,13.76813649,15,3,18,427,445,49,3109,349,3903,157947
4080,9,5,ITA,12,Lazio,41.89277044,12.48366722,344,11,355,3452,3807,158,7242,880,11929,526843
4081,9,5,ITA,7,Liguria,44.41149315,8.9326992,54,7,61,646,707,95,8901,1573,11181,134393
4082,9,5,ITA,3,Lombardia,45.46679409,9.190347404,245,23,268,7654,7922,388,76708,16877,101507,1044945
4083,9,5,ITA,11,Marche,43.61675973,13.5188753,13,1,14,355,369,32,5986,988,7343,126276
4084,9,5,ITA,14,Molise,41.55774754,14.65916051,3,0,3,72,75,0,436,23,534,33674
4085,9,5,ITA,21,P.A. Bolzano,46.49933453,11.35662422,8,2,10,208,218,23,2486,292,2996,75681
4086,9,5,ITA,22,P.A. Trento,46.06893511,11.12123097,6,0,6,270,276,53,4618,405,5299,85463
4087,9,5,ITA,1,Piemonte,45.0732745,7.680687483,106,7,113,1572,1685,54,27365,4150,33200,374263
4088,9,5,ITA,16,Puglia,41.12559576,16.86736689,148,7,155,967,1122,55,4112,562,5796,230046
4089,9,5,ITA,20,Sardegna,39.21531192,9.110616306,44,8,52,1018,1070,65,1280,136,2486,123894
4090,9,5,ITA,19,Sicilia,38.11569725,13.3623567,88,12,100,1243,1343,114,3047,289,4679,281041
4091,9,5,ITA,9,Toscana,43.76923077,11.25588885,69,8,77,1812,1889,113,9260,1143,12292,383856
4092,9,5,ITA,10,Umbria,43.10675841,12.38824698,13,2,15,322,337,16,1472,81,1890,100626
4093,9,5,ITA,2,Valle d'Aosta,45.73750286,7.320149366,1,0,1,33,34,0,1069,146,1249,17954
4094,9,5,ITA,5,Veneto,45.43490485,12.33845213,79,9,88,2789,2877,188,18758,2130,23765,639941
4095,9,6,ITA,13,Abruzzo,42.35122196,13.39843823,32,2,34,475,509,26,2910,472,3891,107501
4096,9,6,ITA,17,Basilicata,40.63947052,15.80514834,4,1,5,118,123,9,413,28,564,58988
4097,9,6,ITA,18,Calabria,38.90597598,16.59440194,25,0,25,324,349,27,1176,98,1623,163844
4098,9,6,ITA,15,Campania,40.83956555,14.25084984,221,7,228,2714,2942,100,4478,448,7868,268075
4099,9,6,ITA,8,Emilia-Romagna,44.49436681,11.3417208,124,14,138,3232,3370,124,24794,4464,32628,563905
4100,9,6,ITA,6,Friuli Venezia Giulia,45.6494354,13.76813649,15,4,19,440,459,20,3115,349,3923,158395
4101,9,6,ITA,12,Lazio,41.89277044,12.48366722,355,10,365,3548,3913,122,7257,881,12051,536609
4102,9,6,ITA,7,Liguria,44.41149315,8.9326992,62,9,71,697,768,111,8949,1575,11292,135222
4103,9,6,ITA,3,Lombardia,45.46679409,9.190347404,248,25,273,7758,8031,198,76794,16880,101705,1053199
4104,9,6,ITA,11,Marche,43.61675973,13.5188753,14,1,15,370,385,20,5990,988,7363,127083
4105,9,6,ITA,14,Molise,41.55774754,14.65916051,3,0,3,74,77,2,436,23,536,33934
4106,9,6,ITA,21,P.A. Bolzano,46.49933453,11.35662422,8,2,10,208,218,7,2493,292,3003,75898
4107,9,6,ITA,22,P.A. Trento,46.06893511,11.12123097,5,0,5,293,298,33,4629,405,5332,86002
4108,9,6,ITA,1,Piemonte,45.0732745,7.680687483,111,8,119,1608,1727,56,27379,4150,33256,376721
4109,9,6,ITA,16,Puglia,41.12559576,16.86736689,155,7,162,1005,1167,60,4126,563,5856,231577
4110,9,6,ITA,20,Sardegna,39.21531192,9.110616306,45,8,53,1032,1085,19,1284,136,2505,124985
4111,9,6,ITA,19,Sicilia,38.11569725,13.3623567,86,13,99,1235,1334,37,3093,289,4716,282977
4112,9,6,ITA,9,Toscana,43.76923077,11.25588885,77,8,85,1909,1994,122,9277,1143,12414,390411
4113,9,6,ITA,10,Umbria,43.10675841,12.38824698,13,2,15,341,356,25,1478,81,1915,101440
4114,9,6,ITA,2,Valle d'Aosta,45.73750286,7.320149366,1,0,1,33,34,0,1069,146,1249,18011
4115,9,6,ITA,5,Veneto,45.43490485,12.33845213,79,12,91,2848,2939,179,18875,2130,23944,643251
4116,9,7,ITA,13,Abruzzo,42.35122196,13.39843823,31,2,33,487,520,15,2914,472,3906,108107
4117,9,7,ITA,17,Basilicata,40.63947052,15.80514834,4,1,5,114,119,1,418,28,565,59060
4118,9,7,ITA,18,Calabria,38.90597598,16.59440194,29,1,30,325,355,17,1187,98,1640,164464
4119,9,7,ITA,15,Campania,40.83956555,14.25084984,223,7,230,2960,3190,218,4490,448,8128,271727
4120,9,7,ITA,8,Emilia-Romagna,44.49436681,11.3417208,119,18,137,3356,3493,132,24803,4464,32760,568812
4121,9,7,ITA,6,Friuli Venezia Giulia,45.6494354,13.76813649,16,4,20,442,462,11,3123,349,3934,159063
4122,9,7,ITA,12,Lazio,41.89277044,12.48366722,359,9,368,3667,4035,159,7294,881,12210,545694
4123,9,7,ITA,7,Liguria,44.41149315,8.9326992,67,10,77,746,823,59,8951,1577,11351,135646
4124,9,7,ITA,3,Lombardia,45.46679409,9.190347404,242,26,268,7842,8110,109,76818,16886,101814,1059954
4125,9,7,ITA,11,Marche,43.61675973,13.5188753,16,1,17,370,387,6,5994,988,7369,127431
4126,9,7,ITA,14,Molise,41.55774754,14.65916051,3,0,3,83,86,9,436,23,545,34109
4127,9,7,ITA,21,P.A. Bolzano,46.49933453,11.35662422,8,2,10,205,215,0,2496,292,3003,76265
4128,9,7,ITA,22,P.A. Trento,46.06893511,11.12123097,5,0,5,310,315,17,4629,405,5349,86198
4129,9,7,ITA,1,Piemonte,45.0732745,7.680687483,105,8,113,1639,1752,37,27390,4151,33293,378191
4130,9,7,ITA,16,Puglia,41.12559576,16.86736689,167,6,173,1024,1197,43,4137,565,5899,233159
4131,9,7,ITA,20,Sardegna,39.21531192,9.110616306,46,10,56,1086,1142,59,1286,136,2564,126031
4132,9,7,ITA,19,Sicilia,38.11569725,13.3623567,101,13,114,1265,1379,49,3097,289,4765,284332
4133,9,7,ITA,9,Toscana,43.76923077,11.25588885,77,9,86,1984,2070,85,9285,1144,12499,395285
4134,9,7,ITA,10,Umbria,43.10675841,12.38824698,15,2,17,349,366,13,1481,81,1928,101836
4135,9,7,ITA,2,Valle d'Aosta,45.73750286,7.320149366,1,0,1,33,34,0,1069,146,1249,18111
4136,9,7,ITA,5,Veneto,45.43490485,12.33845213,85,13,98,2845,2943,69,18940,2130,24013,645256
4137,9,8,ITA,13,Abruzzo,42.35122196,13.39843823,34,2,36,487,523,14,2924,472,3919,108691
4138,9,8,ITA,17,Basilicata,40.63947052,15.80514834,4,1,5,120,125,8,420,28,573,59819
4139,9,8,ITA,18,Calabria,38.90597598,16.59440194,29,1,30,326,356,8,1194,98,1648,165632
4140,9,8,ITA,15,Campania,40.83956555,14.25084984,220,9,229,3186,3415,249,4514,448,8377,277421
4141,9,8,ITA,8,Emilia-Romagna,44.49436681,11.3417208,130,16,146,3386,3532,94,24857,4465,32854,572945
4142,9,8,ITA,6,Friuli Venezia Giulia,45.6494354,13.76813649,18,4,22,451,473,12,3124,349,3946,159635
4143,9,8,ITA,12,Lazio,41.89277044,12.48366722,354,9,363,3761,4124,129,7334,881,12339,554654
4144,9,8,ITA,7,Liguria,44.41149315,8.9326992,85,11,96,764,860,64,8977,1578,11415,137135
4145,9,8,ITA,3,Lombardia,45.46679409,9.190347404,248,27,275,7946,8221,271,76976,16888,102085,1073431
4146,9,8,ITA,11,Marche,43.61675973,13.5188753,16,1,17,380,397,15,5999,988,7384,128178
4147,9,8,ITA,14,Molise,41.55774754,14.65916051,5,0,5,83,88,3,437,23,548,34263
4148,9,8,ITA,21,P.A. Bolzano,46.49933453,11.35662422,8,0,8,210,218,4,2497,292,3007,76699
4149,9,8,ITA,22,P.A. Trento,46.06893511,11.12123097,6,0,6,311,317,3,4630,405,5352,86431
4150,9,8,ITA,1,Piemonte,45.0732745,7.680687483,104,9,113,1656,1769,42,27414,4152,33335,380476
4151,9,8,ITA,16,Puglia,41.12559576,16.86736689,163,7,170,1151,1321,143,4154,567,6042,236175
4152,9,8,ITA,20,Sardegna,39.21531192,9.110616306,48,10,58,1135,1193,51,1286,136,2615,127300
4153,9,8,ITA,19,Sicilia,38.11569725,13.3623567,104,13,117,1337,1454,84,3106,289,4849,287589
4154,9,8,ITA,9,Toscana,43.76923077,11.25588885,74,9,83,1996,2079,59,9334,1145,12558,399495
4155,9,8,ITA,10,Umbria,43.10675841,12.38824698,15,2,17,354,371,7,1483,81,1935,102837
4156,9,8,ITA,2,Valle d'Aosta,45.73750286,7.320149366,2,0,2,37,39,5,1069,146,1254,18188
4157,9,8,ITA,5,Veneto,45.43490485,12.33845213,93,12,105,2809,2914,105,19072,2132,24118,649669
4158,9,9,ITA,13,Abruzzo,42.35122196,13.39843823,35,2,37,469,506,5,2943,472,3921,109697
4159,9,9,ITA,17,Basilicata,40.63947052,15.80514834,4,1,5,133,138,14,421,28,587,60500
4160,9,9,ITA,18,Calabria,38.90597598,16.59440194,27,2,29,333,362,19,1207,98,1667,167110
4161,9,9,ITA,15,Campania,40.83956555,14.25084984,226,10,236,3358,3594,203,4537,449,8580,283355
4162,9,9,ITA,8,Emilia-Romagna,44.49436681,11.3417208,140,16,156,3398,3554,110,24942,4467,32963,578121
4163,9,9,ITA,6,Friuli Venezia Giulia,45.6494354,13.76813649,17,3,20,491,511,54,3140,349,4000,161026
4164,9,9,ITA,12,Lazio,41.89277044,12.48366722,358,9,367,3903,4270,175,7363,881,12514,563118
4165,9,9,ITA,7,Liguria,44.41149315,8.9326992,87,11,98,809,907,51,8980,1579,11466,138436
4166,9,9,ITA,3,Lombardia,45.46679409,9.190347404,252,27,279,8045,8324,218,77088,16891,102303,1087646
4167,9,9,ITA,11,Marche,43.61675973,13.5188753,14,2,16,394,410,19,6005,988,7403,129006
4168,9,9,ITA,14,Molise,41.55774754,14.65916051,4,0,4,88,92,4,437,23,552,34699
4169,9,9,ITA,21,P.A. Bolzano,46.49933453,11.35662422,8,0,8,215,223,10,2502,292,3017,77178
4170,9,9,ITA,22,P.A. Trento,46.06893511,11.12123097,7,0,7,313,320,7,4634,405,5359,86802
4171,9,9,ITA,1,Piemonte,45.0732745,7.680687483,100,9,109,1755,1864,112,27431,4152,33447,383250
4172,9,9,ITA,16,Puglia,41.12559576,16.86736689,172,6,178,1236,1414,97,4158,567,6139,239744
4173,9,9,ITA,20,Sardegna,39.21531192,9.110616306,51,12,63,1170,1233,47,1291,138,2662,128433
4174,9,9,ITA,19,Sicilia,38.11569725,13.3623567,105,15,120,1407,1527,77,3110,289,4926,290674
4175,9,9,ITA,9,Toscana,43.76923077,11.25588885,69,11,80,2061,2141,88,9358,1147,12646,404903
4176,9,9,ITA,10,Umbria,43.10675841,12.38824698,17,2,19,354,373,33,1514,81,1968,103775
4177,9,9,ITA,2,Valle d'Aosta,45.73750286,7.320149366,2,0,2,32,34,0,1074,146,1254,18254
4178,9,9,ITA,5,Veneto,45.43490485,12.33845213,83,12,95,2842,2937,91,19137,2135,24209,653982
4179,9,10,ITA,13,Abruzzo,42.35122196,13.39843823,35,3,38,474,512,11,2948,472,3932,110567
4180,9,10,ITA,17,Basilicata,40.63947052,15.80514834,4,1,5,138,143,6,422,28,593,61164
4181,9,10,ITA,18,Calabria,38.90597598,16.59440194,28,3,31,339,370,8,1207,98,1675,168505
4182,9,10,ITA,15,Campania,40.83956555,14.25084984,232,10,242,3500,3742,180,4568,450,8760,289379
4183,9,10,ITA,8,Emilia-Romagna,44.49436681,11.3417208,143,17,160,3451,3611,110,24994,4468,33073,582928
4184,9,10,ITA,6,Friuli Venezia Giulia,45.6494354,13.76813649,17,3,20,526,546,39,3144,349,4039,161912
4185,9,10,ITA,12,Lazio,41.89277044,12.48366722,372,9,381,4001,4382,163,7413,882,12677,571817
4186,9,10,ITA,7,Liguria,44.41149315,8.9326992,91,11,102,839,941,114,9060,1579,11580,139851
4187,9,10,ITA,3,Lombardia,45.46679409,9.190347404,256,30,286,8166,8452,245,77204,16892,102548,1098986
4188,9,10,ITA,11,Marche,43.61675973,13.5188753,11,2,13,426,439,40,6015,989,7443,129830
4189,9,10,ITA,14,Molise,41.55774754,14.65916051,4,0,4,91,95,3,437,23,555,35157
4190,9,10,ITA,21,P.A. Bolzano,46.49933453,11.35662422,8,0,8,231,239,20,2506,292,3037,77764
4191,9,10,ITA,22,P.A. Trento,46.06893511,11.12123097,6,0,6,392,398,82,4638,405,5441,87467
4192,9,10,ITA,1,Piemonte,45.0732745,7.680687483,110,9,119,1799,1918,74,27450,4153,33521,385183
4193,9,10,ITA,16,Puglia,41.12559576,16.86736689,179,8,187,1283,1470,70,4169,570,6209,242098
4194,9,10,ITA,20,Sardegna,39.21531192,9.110616306,57,12,69,1217,1286,63,1300,139,2725,130074
4195,9,10,ITA,19,Sicilia,38.11569725,13.3623567,108,18,126,1477,1603,106,3140,289,5032,293401
4196,9,10,ITA,9,Toscana,43.76923077,11.25588885,74,13,87,2127,2214,92,9377,1147,12738,409901
4197,9,10,ITA,10,Umbria,43.10675841,12.38824698,16,3,19,371,390,24,1521,81,1992,104824
4198,9,10,ITA,2,Valle d'Aosta,45.73750286,7.320149366,2,0,2,29,31,0,1077,146,1254,18332
4199,9,10,ITA,5,Veneto,45.43490485,12.33845213,83,12,95,2831,2926,147,19295,2135,24356,658348
4200,9,11,ITA,13,Abruzzo,42.35122196,13.39843823,36,4,40,501,541,35,2954,472,3967,111700
4201,9,11,ITA,17,Basilicata,40.63947052,15.80514834,4,1,5,149,154,12,423,28,605,61777
4202,9,11,ITA,18,Calabria,38.90597598,16.59440194,28,3,31,339,370,8,1215,98,1683,170074
4203,9,11,ITA,15,Campania,40.83956555,14.25084984,239,13,252,3613,3865,140,4584,451,8900,296120
4204,9,11,ITA,8,Emilia-Romagna,44.49436681,11.3417208,140,18,158,3572,3730,152,25027,4468,33225,587767
4205,9,11,ITA,6,Friuli Venezia Giulia,45.6494354,13.76813649,17,3,20,542,562,34,3162,349,4073,162976
4206,9,11,ITA,12,Lazio,41.89277044,12.48366722,365,14,379,4097,4476,148,7466,883,12825,581864
4207,9,11,ITA,7,Liguria,44.41149315,8.9326992,96,12,108,886,994,82,9089,1579,11662,141350
4208,9,11,ITA,3,Lombardia,45.46679409,9.190347404,246,27,273,8318,8591,257,77318,16896,102805,1110428
4209,9,11,ITA,11,Marche,43.61675973,13.5188753,13,2,15,451,466,41,6029,989,7484,130636
4210,9,11,ITA,14,Molise,41.55774754,14.65916051,4,0,4,84,88,4,448,23,559,35541
4211,9,11,ITA,21,P.A. Bolzano,46.49933453,11.35662422,8,0,8,247,255,26,2516,292,3063,78315
4212,9,11,ITA,22,P.A. Trento,46.06893511,11.12123097,6,0,6,416,422,29,4643,405,5470,88084
4213,9,11,ITA,1,Piemonte,45.0732745,7.680687483,102,9,111,1849,1960,57,27465,4153,33578,386993
4214,9,11,ITA,16,Puglia,41.12559576,16.86736689,188,8,196,1350,1546,82,4175,570,6291,244885
4215,9,11,ITA,20,Sardegna,39.21531192,9.110616306,61,12,73,1264,1337,65,1314,139,2790,131993
4216,9,11,ITA,19,Sicilia,38.11569725,13.3623567,112,17,129,1577,1706,104,3141,289,5136,295881
4217,9,11,ITA,9,Toscana,43.76923077,11.25588885,72,17,89,2223,2312,147,9425,1148,12885,414906
4218,9,11,ITA,10,Umbria,43.10675841,12.38824698,19,4,23,372,395,17,1533,81,2009,105483
4219,9,11,ITA,2,Valle d'Aosta,45.73750286,7.320149366,2,0,2,31,33,3,1078,146,1257,18368
4220,9,11,ITA,5,Veneto,45.43490485,12.33845213,91,11,102,2862,2964,173,19427,2138,24529,663769
4221,9,12,ITA,13,Abruzzo,42.35122196,13.39843823,37,3,40,504,544,11,2962,472,3978,112658
4222,9,12,ITA,17,Basilicata,40.63947052,15.80514834,5,1,6,149,155,5,427,28,610,62601
4223,9,12,ITA,18,Calabria,38.90597598,16.59440194,28,3,31,357,388,18,1215,98,1701,171604
4224,9,12,ITA,15,Campania,40.83956555,14.25084984,254,17,271,3627,3898,103,4654,451,9003,300981
4225,9,12,ITA,8,Emilia-Romagna,44.49436681,11.3417208,152,17,169,3658,3827,138,25067,4469,33363,592684
4226,9,12,ITA,6,Friuli Venezia Giulia,45.6494354,13.76813649,18,2,20,566,586,39,3177,349,4112,163837
4227,9,12,ITA,12,Lazio,41.89277044,12.48366722,401,16,417,4204,4621,155,7475,884,12980,590692
4228,9,12,ITA,7,Liguria,44.41149315,8.9326992,109,11,120,968,1088,112,9107,1579,11774,142774
4229,9,12,ITA,3,Lombardia,45.46679409,9.190347404,251,27,278,8289,8567,269,77611,16896,103074,1120531
4230,9,12,ITA,11,Marche,43.61675973,13.5188753,12,2,14,472,486,27,6036,989,7511,131401
4231,9,12,ITA,14,Molise,41.55774754,14.65916051,3,0,3,87,90,3,449,23,562,35775
4232,9,12,ITA,21,P.A. Bolzano,46.49933453,11.35662422,8,0,8,258,266,25,2530,292,3088,79095
4233,9,12,ITA,22,P.A. Trento,46.06893511,11.12123097,8,0,8,429,437,22,4650,405,5492,88749
4234,9,12,ITA,1,Piemonte,45.0732745,7.680687483,104,9,113,1917,2030,93,27488,4153,33671,388781
4235,9,12,ITA,16,Puglia,41.12559576,16.86736689,189,8,197,1402,1599,76,4198,570,6367,248777
4236,9,12,ITA,20,Sardegna,39.21531192,9.110616306,62,14,76,1303,1379,51,1322,140,2841,133503
4237,9,12,ITA,19,Sicilia,38.11569725,13.3623567,116,18,134,1613,1747,44,3144,289,5180,298359
4238,9,12,ITA,9,Toscana,43.76923077,11.25588885,74,18,92,2310,2402,138,9473,1148,13023,419422
4239,9,12,ITA,10,Umbria,43.10675841,12.38824698,18,4,22,397,419,33,1542,81,2042,106482
4240,9,12,ITA,2,Valle d'Aosta,45.73750286,7.320149366,3,0,3,31,34,1,1078,146,1258,18424
4241,9,12,ITA,5,Veneto,45.43490485,12.33845213,99,12,111,2829,2940,138,19586,2141,24667,668332
4242,9,13,ITA,13,Abruzzo,42.35122196,13.39843823,41,3,44,535,579,37,2964,472,4015,113956
4243,9,13,ITA,17,Basilicata,40.63947052,15.80514834,5,1,6,150,156,3,429,28,613,62961
4244,9,13,ITA,18,Calabria,38.90597598,16.59440194,29,3,32,363,395,14,1222,98,1715,172919
4245,9,13,ITA,15,Campania,40.83956555,14.25084984,271,19,290,3651,3941,122,4733,451,9125,304705
4246,9,13,ITA,8,Emilia-Romagna,44.49436681,11.3417208,156,17,173,3766,3939,143,25096,4469,33504,597178
4247,9,13,ITA,6,Friuli Venezia Giulia,45.6494354,13.76813649,23,2,25,564,589,45,3219,349,4157,164825
4248,9,13,ITA,12,Lazio,41.89277044,12.48366722,424,17,441,4314,4755,143,7483,885,13123,598963
4249,9,13,ITA,7,Liguria,44.41149315,8.9326992,115,11,126,1017,1143,78,9130,1579,11852,143543
4250,9,13,ITA,3,Lombardia,45.46679409,9.190347404,252,28,280,8509,8789,265,77651,16899,103339,1128937
4251,9,13,ITA,11,Marche,43.61675973,13.5188753,14,2,16,504,520,39,6041,989,7550,132323
4252,9,13,ITA,14,Molise,41.55774754,14.65916051,3,1,4,89,93,3,449,23,565,36107
4253,9,13,ITA,21,P.A. Bolzano,46.49933453,11.35662422,8,0,8,288,296,40,2540,292,3128,79873
4254,9,13,ITA,22,P.A. Trento,46.06893511,11.12123097,9,0,9,433,442,9,4654,405,5501,89234
4255,9,13,ITA,1,Piemonte,45.0732745,7.680687483,100,8,108,1989,2097,82,27503,4153,33753,391637
4256,9,13,ITA,16,Puglia,41.12559576,16.86736689,195,9,204,1474,1678,82,4201,570,6449,250467
4257,9,13,ITA,20,Sardegna,39.21531192,9.110616306,80,14,94,1310,1404,33,1330,140,2874,134443
4258,9,13,ITA,19,Sicilia,38.11569725,13.3623567,120,17,137,1656,1793,61,3158,290,5241,300490
4259,9,13,ITA,9,Toscana,43.76923077,11.25588885,80,17,97,2362,2459,91,9506,1149,13114,424101
4260,9,13,ITA,10,Umbria,43.10675841,12.38824698,19,4,23,415,438,24,1547,81,2066,107219
4261,9,13,ITA,2,Valle d'Aosta,45.73750286,7.320149366,3,0,3,33,36,2,1078,146,1260,18539
4262,9,13,ITA,5,Veneto,45.43490485,12.33845213,95,14,109,2858,2967,142,19700,2142,24809,671902
4263,9,14,ITA,13,Abruzzo,42.35122196,13.39843823,41,4,45,532,577,1,2966,473,4016,114031
4264,9,14,ITA,17,Basilicata,40.63947052,15.80514834,5,1,6,150,156,0,429,28,613,63023
4265,9,14,ITA,18,Calabria,38.90597598,16.59440194,29,2,31,344,375,3,1245,98,1718,173593
4266,9,14,ITA,15,Campania,40.83956555,14.25084984,286,19,305,3699,4004,90,4759,452,9215,306866
4267,9,14,ITA,8,Emilia-Romagna,44.49436681,11.3417208,165,18,183,3881,4064,127,25098,4469,33631,599934
4268,9,14,ITA,6,Friuli Venezia Giulia,45.6494354,13.76813649,22,3,25,567,592,4,3220,349,4161,165276
4269,9,14,ITA,12,Lazio,41.89277044,12.48366722,410,17,427,4469,4896,181,7523,885,13304,606736
4270,9,14,ITA,7,Liguria,44.41149315,8.9326992,126,12,138,1062,1200,65,9135,1582,11917,144077
4271,9,14,ITA,3,Lombardia,45.46679409,9.190347404,262,28,290,8558,8848,125,77715,16901,103464,1134109
4272,9,14,ITA,11,Marche,43.61675973,13.5188753,15,2,17,511,528,11,6044,989,7561,132543
4273,9,14,ITA,14,Molise,41.55774754,14.65916051,4,1,5,91,96,4,450,23,569,36332
4274,9,14,ITA,21,P.A. Bolzano,46.49933453,11.35662422,8,0,8,295,303,7,2540,292,3135,80293
4275,9,14,ITA,22,P.A. Trento,46.06893511,11.12123097,11,0,11,448,459,20,4657,405,5521,89459
4276,9,14,ITA,1,Piemonte,45.0732745,7.680687483,114,9,123,2006,2129,61,27532,4153,33814,393413
4277,9,14,ITA,16,Puglia,41.12559576,16.86736689,203,11,214,1499,1713,61,4225,572,6510,252699
4278,9,14,ITA,20,Sardegna,39.21531192,9.110616306,85,16,101,1339,1440,54,1348,140,2928,135511
4279,9,14,ITA,19,Sicilia,38.11569725,13.3623567,136,16,152,1690,1842,65,3172,292,5306,301876
4280,9,14,ITA,9,Toscana,43.76923077,11.25588885,82,18,100,2400,2500,59,9523,1150,13173,426415
4281,9,14,ITA,10,Umbria,43.10675841,12.38824698,19,5,24,419,443,12,1554,81,2078,107533
4282,9,14,ITA,2,Valle d'Aosta,45.73750286,7.320149366,3,1,4,35,39,3,1078,146,1263,18560
4283,9,14,ITA,5,Veneto,45.43490485,12.33845213,96,14,110,2873,2983,55,19737,2144,24864,673892
4284,9,15,ITA,13,Abruzzo,42.35122196,13.39843823,42,4,46,545,591,18,2970,473,4034,114687
4285,9,15,ITA,17,Basilicata,40.63947052,15.80514834,6,1,7,154,161,5,429,28,618,63520
4286,9,15,ITA,18,Calabria,38.90597598,16.59440194,31,2,33,341,374,4,1250,98,1722,174778
4287,9,15,ITA,15,Campania,40.83956555,14.25084984,295,18,313,3767,4080,136,4819,452,9351,310227
4288,9,15,ITA,8,Emilia-Romagna,44.49436681,11.3417208,168,17,185,3917,4102,125,25184,4470,33756,603369
4289,9,15,ITA,6,Friuli Venezia Giulia,45.6494354,13.76813649,24,2,26,583,609,20,3223,349,4181,166049
4290,9,15,ITA,12,Lazio,41.89277044,12.48366722,453,18,471,4526,4997,139,7559,887,13443,614394
4291,9,15,ITA,7,Liguria,44.41149315,8.9326992,128,12,140,1111,1251,141,9225,1582,12058,145476
4292,9,15,ITA,3,Lombardia,45.46679409,9.190347404,263,29,292,8507,8799,176,77938,16903,103640,1148425
4293,9,15,ITA,11,Marche,43.61675973,13.5188753,17,2,19,517,536,14,6050,989,7575,133279
4294,9,15,ITA,14,Molise,41.55774754,14.65916051,5,1,6,91,97,1,450,23,570,36565
4295,9,15,ITA,21,P.A. Bolzano,46.49933453,11.35662422,15,1,16,304,320,21,2544,292,3156,80736
4296,9,15,ITA,22,P.A. Trento,46.06893511,11.12123097,9,0,9,465,474,20,4662,405,5541,89798
4297,9,15,ITA,1,Piemonte,45.0732745,7.680687483,112,8,120,2037,2157,39,27543,4153,33853,394783
4298,9,15,ITA,16,Puglia,41.12559576,16.86736689,204,13,217,1559,1776,76,4237,573,6586,255154
4299,9,15,ITA,20,Sardegna,39.21531192,9.110616306,86,18,104,1353,1457,36,1367,140,2964,136896
4300,9,15,ITA,19,Sicilia,38.11569725,13.3623567,141,17,158,1761,1919,77,3172,292,5383,304795
4301,9,15,ITA,9,Toscana,43.76923077,11.25588885,93,17,110,2417,2527,41,9536,1151,13214,429310
4302,9,15,ITA,10,Umbria,43.10675841,12.38824698,23,6,29,430,459,22,1560,81,2100,108521
4303,9,15,ITA,2,Valle d'Aosta,45.73750286,7.320149366,5,0,5,37,42,3,1078,146,1266,18657
4304,9,15,ITA,5,Veneto,45.43490485,12.33845213,102,15,117,2867,2984,115,19849,2146,24979,677256
4305,9,16,ITA,13,Abruzzo,42.35122196,13.39843823,42,5,47,559,606,18,2973,473,4052,115700
4306,9,16,ITA,17,Basilicata,40.63947052,15.80514834,6,1,7,157,164,5,431,28,623,64053
4307,9,16,ITA,18,Calabria,38.90597598,16.59440194,28,2,30,359,389,19,1254,98,1741,176447
4308,9,16,ITA,15,Campania,40.83956555,14.25084984,301,19,320,3877,4197,186,4888,452,9537,315063
4309,9,16,ITA,8,Emilia-Romagna,44.49436681,11.3417208,174,19,193,3986,4179,106,25213,4470,33862,607881
4310,9,16,ITA,6,Friuli Venezia Giulia,45.6494354,13.76813649,22,3,25,587,612,29,3249,349,4210,167456
4311,9,16,ITA,12,Lazio,41.89277044,12.48366722,467,18,485,4643,5128,165,7593,887,13608,621049
4312,9,16,ITA,7,Liguria,44.41149315,8.9326992,136,13,149,1174,1323,73,9225,1583,12131,147046
4313,9,16,ITA,3,Lombardia,45.46679409,9.190347404,264,30,294,8510,8804,159,78090,16905,103799,1160353
4314,9,16,ITA,11,Marche,43.61675973,13.5188753,15,2,17,544,561,38,6063,989,7613,134034
4315,9,16,ITA,14,Molise,41.55774754,14.65916051,3,1,4,95,99,6,454,23,576,36757
4316,9,16,ITA,21,P.A. Bolzano,46.49933453,11.35662422,17,2,19,304,323,12,2553,292,3168,81388
4317,9,16,ITA,22,P.A. Trento,46.06893511,11.12123097,13,0,13,488,501,32,4667,405,5573,90609
4318,9,16,ITA,1,Piemonte,45.0732745,7.680687483,123,6,129,2098,2227,117,27590,4153,33970,397218
4319,9,16,ITA,16,Puglia,41.12559576,16.86736689,204,14,218,1645,1863,103,4252,574,6689,257428
4320,9,16,ITA,20,Sardegna,39.21531192,9.110616306,88,17,105,1375,1480,27,1371,140,2991,138426
4321,9,16,ITA,19,Sicilia,38.11569725,13.3623567,155,16,171,1817,1988,90,3190,295,5473,308515
4322,9,16,ITA,9,Toscana,43.76923077,11.25588885,88,20,108,2480,2588,90,9565,1151,13304,433964
4323,9,16,ITA,10,Umbria,43.10675841,12.38824698,27,5,32,436,468,17,1568,81,2117,109462
4324,9,16,ITA,2,Valle d'Aosta,45.73750286,7.320149366,5,0,5,37,42,1,1079,146,1267,18731
4325,9,16,ITA,5,Veneto,45.43490485,12.33845213,107,14,121,2869,2990,159,19997,2151,25138,683212
4326,9,17,ITA,13,Abruzzo,42.35122196,13.39843823,45,5,50,582,632,33,2978,473,4083,116740
4327,9,17,ITA,17,Basilicata,40.63947052,15.80514834,6,1,7,159,166,5,434,28,628,64636
4328,9,17,ITA,18,Calabria,38.90597598,16.59440194,26,4,30,375,405,16,1254,98,1757,178292
4329,9,17,ITA,15,Campania,40.83956555,14.25084984,302,21,323,3984,4307,195,4970,455,9732,321975
4330,9,17,ITA,8,Emilia-Romagna,44.49436681,11.3417208,178,21,199,4078,4277,110,25224,4471,33972,612312
4331,9,17,ITA,6,Friuli Venezia Giulia,45.6494354,13.76813649,22,4,26,630,656,63,3268,349,4273,168808
4332,9,17,ITA,12,Lazio,41.89277044,12.48366722,492,16,508,4775,5283,181,7617,889,13789,629051
4333,9,17,ITA,7,Liguria,44.41149315,8.9326992,135,15,150,1208,1358,40,9227,1586,12171,148192
4334,9,17,ITA,3,Lombardia,45.46679409,9.190347404,272,32,304,8630,8934,281,78240,16906,104080,1173781
4335,9,17,ITA,11,Marche,43.61675973,13.5188753,20,2,22,560,582,37,6079,989,7650,135016
4336,9,17,ITA,14,Molise,41.55774754,14.65916051,3,1,4,96,100,2,455,23,578,37023
4337,9,17,ITA,21,P.A. Bolzano,46.49933453,11.35662422,15,2,17,309,326,15,2565,292,3183,82321
4338,9,17,ITA,22,P.A. Trento,46.06893511,11.12123097,11,0,11,560,571,76,4673,405,5649,91333
4339,9,17,ITA,1,Piemonte,45.0732745,7.680687483,136,6,142,2080,2222,70,27665,4153,34040,399601
4340,9,17,ITA,16,Puglia,41.12559576,16.86736689,200,14,214,1701,1915,63,4262,575,6752,260264
4341,9,17,ITA,20,Sardegna,39.21531192,9.110616306,84,17,101,1413,1514,51,1388,140,3042,140077
4342,9,17,ITA,19,Sicilia,38.11569725,13.3623567,173,14,187,1856,2043,96,3231,295,5569,312007
4343,9,17,ITA,9,Toscana,43.76923077,11.25588885,89,20,109,2541,2650,119,9621,1152,13423,439124
4344,9,17,ITA,10,Umbria,43.10675841,12.38824698,25,5,30,437,467,22,1590,82,2139,110422
4345,9,17,ITA,2,Valle d'Aosta,45.73750286,7.320149366,5,0,5,36,41,1,1081,146,1268,18904
4346,9,17,ITA,5,Veneto,45.43490485,12.33845213,109,12,121,2843,2964,109,20132,2151,25247,687364
4347,9,18,ITA,13,Abruzzo,42.35122196,13.39843823,48,5,53,626,679,54,2984,474,4137,117719
4348,9,18,ITA,17,Basilicata,40.63947052,15.80514834,6,1,7,156,163,0,437,28,628,65074
4349,9,18,ITA,18,Calabria,38.90597598,16.59440194,24,4,28,393,421,28,1266,98,1785,180069
4350,9,18,ITA,15,Campania,40.83956555,14.25084984,318,20,338,4127,4465,208,5020,455,9940,328713
4351,9,18,ITA,8,Emilia-Romagna,44.49436681,11.3417208,182,21,203,4166,4369,121,25252,4472,34093,616330
4352,9,18,ITA,6,Friuli Venezia Giulia,45.6494354,13.76813649,22,4,26,646,672,39,3291,349,4312,169788
4353,9,18,ITA,12,Lazio,41.89277044,12.48366722,459,17,476,4937,5413,193,7680,889,13982,637844
4354,9,18,ITA,7,Liguria,44.41149315,8.9326992,141,16,157,1257,1414,158,9329,1586,12329,150104
4355,9,18,ITA,3,Lombardia,45.46679409,9.190347404,284,32,316,8711,9027,224,78369,16908,104304,1184027
4356,9,18,ITA,11,Marche,43.61675973,13.5188753,22,1,23,583,606,29,6084,989,7679,135887
4357,9,18,ITA,14,Molise,41.55774754,14.65916051,3,1,4,96,100,3,458,23,581,37522
4358,9,18,ITA,21,P.A. Bolzano,46.49933453,11.35662422,15,2,17,368,385,72,2578,292,3255,83325
4359,9,18,ITA,22,P.A. Trento,46.06893511,11.12123097,12,0,12,546,558,18,4704,405,5667,91799
4360,9,18,ITA,1,Piemonte,45.0732745,7.680687483,140,6,146,2116,2262,127,27752,4153,34167,401619
4361,9,18,ITA,16,Puglia,41.12559576,16.86736689,200,12,212,1774,1986,84,4273,577,6836,263073
4362,9,18,ITA,20,Sardegna,39.21531192,9.110616306,89,17,106,1461,1567,66,1400,141,3108,141571
4363,9,18,ITA,19,Sicilia,38.11569725,13.3623567,179,15,194,1963,2157,179,3295,296,5748,316122
4364,9,18,ITA,9,Toscana,43.76923077,11.25588885,95,21,116,2584,2700,99,9670,1152,13522,444645
4365,9,18,ITA,10,Umbria,43.10675841,12.38824698,27,5,32,423,455,21,1623,82,2160,111396
4366,9,18,ITA,2,Valle d'Aosta,45.73750286,7.320149366,6,0,6,43,49,8,1081,146,1276,18953
4367,9,18,ITA,5,Veneto,45.43490485,12.33845213,115,8,123,2886,3009,176,20261,2153,25423,691678
4368,9,19,ITA,13,Abruzzo,42.35122196,13.39843823,48,5,53,626,679,0,2984,474,4137,117719
4369,9,19,ITA,17,Basilicata,40.63947052,15.80514834,6,1,7,158,165,3,438,28,631,65708
4370,9,19,ITA,18,Calabria,38.90597598,16.59440194,27,4,31,414,445,25,1267,98,1810,181949
4371,9,19,ITA,15,Campania,40.83956555,14.25084984,327,19,346,4227,4573,149,5060,456,10089,333778
4372,9,19,ITA,8,Emilia-Romagna,44.49436681,11.3417208,174,19,193,4245,4438,133,25313,4474,34225,620451
4373,9,19,ITA,6,Friuli Venezia Giulia,45.6494354,13.76813649,20,3,23,658,681,33,3314,350,4345,170885
4374,9,19,ITA,12,Lazio,41.89277044,12.48366722,445,22,467,5071,5538,197,7751,890,14179,646453
4375,9,19,ITA,7,Liguria,44.41149315,8.9326992,140,16,156,1277,1433,78,9386,1588,12407,151550
4376,9,19,ITA,3,Lombardia,45.46679409,9.190347404,271,36,307,8628,8935,243,78695,16917,104547,1197038
4377,9,19,ITA,11,Marche,43.61675973,13.5188753,23,2,25,596,621,24,6093,989,7703,136589
4378,9,19,ITA,14,Molise,41.55774754,14.65916051,5,1,6,98,104,5,459,23,586,37847
4379,9,19,ITA,21,P.A. Bolzano,46.49933453,11.35662422,15,2,17,388,405,26,2584,292,3281,84628
4380,9,19,ITA,22,P.A. Trento,46.06893511,11.12123097,10,0,10,524,534,22,4750,405,5689,92546
4381,9,19,ITA,1,Piemonte,45.0732745,7.680687483,140,6,146,2158,2304,74,27783,4154,34241,403513
4382,9,19,ITA,16,Puglia,41.12559576,16.86736689,201,13,214,1874,2088,108,4278,578,6944,265618
4383,9,19,ITA,20,Sardegna,39.21531192,9.110616306,91,18,109,1486,1595,59,1431,141,3167,143431
4384,9,19,ITA,19,Sicilia,38.11569725,13.3623567,191,13,204,2028,2232,98,3318,296,5846,318845
4385,9,19,ITA,9,Toscana,43.76923077,11.25588885,88,21,109,2718,2827,143,9686,1152,13665,450613
4386,9,19,ITA,10,Umbria,43.10675841,12.38824698,27,4,31,440,471,32,1638,83,2192,112361
4387,9,19,ITA,2,Valle d'Aosta,45.73750286,7.320149366,6,0,6,42,48,0,1082,146,1276,19040
4388,9,19,ITA,5,Veneto,45.43490485,12.33845213,125,10,135,2910,3045,186,20406,2158,25609,697466
4389,9,20,ITA,13,Abruzzo,42.35122196,13.39843823,48,5,53,626,679,0,2984,474,4137,117719
4390,9,20,ITA,17,Basilicata,40.63947052,15.80514834,6,1,7,159,166,6,443,28,637,66035
4391,9,20,ITA,18,Calabria,38.90597598,16.59440194,30,4,34,427,461,22,1273,98,1832,183581
4392,9,20,ITA,15,Campania,40.83956555,14.25084984,344,22,366,4309,4675,171,5129,456,10260,339764
4393,9,20,ITA,8,Emilia-Romagna,44.49436681,11.3417208,169,19,188,4341,4529,115,25335,4476,34340,625160
4394,9,20,ITA,6,Friuli Venezia Giulia,45.6494354,13.76813649,19,4,23,663,686,32,3341,350,4377,171811
4395,9,20,ITA,12,Lazio,41.89277044,12.48366722,422,23,445,5244,5689,165,7765,890,14344,655297
4396,9,20,ITA,7,Liguria,44.41149315,8.9326992,136,15,151,1310,1461,85,9440,1591,12492,152634
4397,9,20,ITA,3,Lombardia,45.46679409,9.190347404,264,38,302,8705,9007,211,78829,16922,104758,1206551
4398,9,20,ITA,11,Marche,43.61675973,13.5188753,21,2,23,619,642,31,6103,989,7734,137510
4399,9,20,ITA,14,Molise,41.55774754,14.65916051,4,1,5,99,104,1,460,23,587,38140
4400,9,20,ITA,21,P.A. Bolzano,46.49933453,11.35662422,15,2,17,405,422,20,2587,292,3301,85316
4401,9,20,ITA,22,P.A. Trento,46.06893511,11.12123097,13,0,13,544,557,45,4772,405,5734,93131
4402,9,20,ITA,1,Piemonte,45.0732745,7.680687483,142,7,149,2177,2326,98,27859,4154,34339,407611
4403,9,20,ITA,16,Puglia,41.12559576,16.86736689,199,11,210,1918,2128,50,4287,579,6994,267208
4404,9,20,ITA,20,Sardegna,39.21531192,9.110616306,96,18,114,1551,1665,72,1433,141,3239,144511
4405,9,20,ITA,19,Sicilia,38.11569725,13.3623567,194,13,207,2109,2316,116,3350,296,5962,321168
4406,9,20,ITA,9,Toscana,43.76923077,11.25588885,86,23,109,2847,2956,147,9704,1152,13812,455978
4407,9,20,ITA,10,Umbria,43.10675841,12.38824698,29,4,33,452,485,24,1648,83,2216,113041
4408,9,20,ITA,2,Valle d'Aosta,45.73750286,7.320149366,4,0,4,47,51,3,1082,146,1279,19140
4409,9,20,ITA,5,Veneto,45.43490485,12.33845213,124,10,134,2959,3093,173,20527,2162,25782,701455
4410,9,21,ITA,13,Abruzzo,42.35122196,13.39843823,58,5,63,676,739,72,2995,475,4209,120157
4411,9,21,ITA,17,Basilicata,40.63947052,15.80514834,7,1,8,155,163,1,447,28,638,66117
4412,9,21,ITA,18,Calabria,38.90597598,16.59440194,30,4,34,434,468,12,1278,98,1844,184501
4413,9,21,ITA,15,Campania,40.83956555,14.25084984,345,21,366,4531,4897,243,5149,457,10503,345005
4414,9,21,ITA,8,Emilia-Romagna,44.49436681,11.3417208,167,23,190,4428,4618,116,25361,4477,34456,627269
4415,9,21,ITA,6,Friuli Venezia Giulia,45.6494354,13.76813649,20,5,25,671,696,13,3344,350,4390,172262
4416,9,21,ITA,12,Lazio,41.89277044,12.48366722,466,27,493,5347,5840,198,7807,895,14542,662743
4417,9,21,ITA,7,Liguria,44.41149315,8.9326992,145,15,160,1365,1525,64,9440,1591,12556,153324
4418,9,21,ITA,3,Lombardia,45.46679409,9.190347404,283,36,319,8757,9076,90,78849,16923,104848,1213246
4419,9,21,ITA,11,Marche,43.61675973,13.5188753,24,2,26,624,650,17,6112,989,7751,137930
4420,9,21,ITA,14,Molise,41.55774754,14.65916051,5,1,6,126,132,31,463,23,618,38386
4421,9,21,ITA,21,P.A. Bolzano,46.49933453,11.35662422,16,1,17,423,440,20,2589,292,3321,85880
4422,9,21,ITA,22,P.A. Trento,46.06893511,11.12123097,13,0,13,545,558,2,4773,405,5736,93200
4423,9,21,ITA,1,Piemonte,45.0732745,7.680687483,143,7,150,2208,2358,57,27883,4155,34396,410265
4424,9,21,ITA,16,Puglia,41.12559576,16.86736689,201,11,212,1977,2189,81,4306,580,7075,268745
4425,9,21,ITA,20,Sardegna,39.21531192,9.110616306,98,20,118,1596,1714,64,1446,143,3303,145340
4426,9,21,ITA,19,Sicilia,38.11569725,13.3623567,203,14,217,2131,2348,75,3390,299,6037,323104
4427,9,21,ITA,9,Toscana,43.76923077,11.25588885,94,23,117,2901,3018,84,9726,1152,13896,459147
4428,9,21,ITA,10,Umbria,43.10675841,12.38824698,25,4,29,439,468,5,1669,84,2221,113380
4429,9,21,ITA,2,Valle d'Aosta,45.73750286,7.320149366,3,0,3,45,48,2,1087,146,1281,19210
4430,9,21,ITA,5,Veneto,45.43490485,12.33845213,129,12,141,2993,3134,103,20589,2162,25885,703443
4431,9,22,ITA,13,Abruzzo,42.35122196,13.39843823,54,5,59,683,742,18,3010,475,4227,120852
4432,9,22,ITA,17,Basilicata,40.63947052,15.80514834,10,1,11,166,177,14,447,28,652,66694
4433,9,22,ITA,18,Calabria,38.90597598,16.59440194,29,4,33,457,490,24,1280,98,1868,186032
4434,9,22,ITA,15,Campania,40.83956555,14.25084984,360,23,383,4572,4955,156,5247,457,10659,345740
4435,9,22,ITA,8,Emilia-Romagna,44.49436681,11.3417208,185,22,207,4426,4633,56,25400,4478,34511,631253
4436,9,22,ITA,6,Friuli Venezia Giulia,45.6494354,13.76813649,21,5,26,677,703,14,3351,350,4404,173067
4437,9,22,ITA,12,Lazio,41.89277044,12.48366722,482,31,513,5517,6030,238,7851,899,14780,669956
4438,9,22,ITA,7,Liguria,44.41149315,8.9326992,148,17,165,1365,1530,105,9539,1592,12661,154818
4439,9,22,ITA,3,Lombardia,45.46679409,9.190347404,294,34,328,8699,9027,182,79078,16925,105030,1225067
4440,9,22,ITA,11,Marche,43.61675973,13.5188753,24,3,27,633,660,18,6120,989,7769,138616
4441,9,22,ITA,14,Molise,41.55774754,14.65916051,5,1,6,125,131,2,466,23,620,38579
4442,9,22,ITA,21,P.A. Bolzano,46.49933453,11.35662422,20,1,21,427,448,8,2589,292,3329,86311
4443,9,22,ITA,22,P.A. Trento,46.06893511,11.12123097,13,0,13,535,548,25,4808,405,5761,93785
4444,9,22,ITA,1,Piemonte,45.0732745,7.680687483,164,7,171,2222,2393,84,27931,4156,34480,411192
4445,9,22,ITA,16,Puglia,41.12559576,16.86736689,204,10,214,1976,2190,67,4371,581,7142,271426
4446,9,22,ITA,20,Sardegna,39.21531192,9.110616306,96,21,117,1606,1723,53,1490,143,3356,147183
4447,9,22,ITA,19,Sicilia,38.11569725,13.3623567,224,15,239,2151,2390,108,3455,300,6145,327407
4448,9,22,ITA,9,Toscana,43.76923077,11.25588885,98,21,119,2939,3058,74,9760,1152,13970,462715
4449,9,22,ITA,10,Umbria,43.10675841,12.38824698,28,4,32,437,469,26,1694,84,2247,114754
4450,9,22,ITA,2,Valle d'Aosta,45.73750286,7.320149366,4,0,4,45,49,1,1087,146,1282,19320
4451,9,22,ITA,5,Veneto,45.43490485,12.33845213,141,14,155,2988,3143,119,20696,2165,26004,707232
4452,9,23,ITA,13,Abruzzo,42.35122196,13.39843823,55,4,59,701,760,22,3012,477,4249,122050
4453,9,23,ITA,17,Basilicata,40.63947052,15.80514834,12,1,13,179,192,17,449,28,669,67261
4454,9,23,ITA,18,Calabria,38.90597598,16.59440194,27,4,31,474,505,19,1284,98,1887,187925
4455,9,23,ITA,15,Campania,40.83956555,14.25084984,356,22,378,4689,5067,248,5383,457,10907,350063
4456,9,23,ITA,8,Emilia-Romagna,44.49436681,11.3417208,187,20,207,4406,4613,101,25520,4479,34612,636603
4457,9,23,ITA,6,Friuli Venezia Giulia,45.6494354,13.76813649,16,6,22,688,710,57,3401,350,4461,174659
4458,9,23,ITA,12,Lazio,41.89277044,12.48366722,521,32,553,5631,6184,195,7889,902,14975,678371
4459,9,23,ITA,7,Liguria,44.41149315,8.9326992,149,18,167,1426,1593,108,9582,1594,12769,156756
4460,9,23,ITA,3,Lombardia,45.46679409,9.190347404,308,33,341,8763,9104,196,79197,16925,105226,1239028
4461,9,23,ITA,11,Marche,43.61675973,13.5188753,24,4,28,658,686,32,6126,989,7801,139445
4462,9,23,ITA,14,Molise,41.55774754,14.65916051,3,1,4,128,132,3,468,23,623,39092
4463,9,23,ITA,21,P.A. Bolzano,46.49933453,11.35662422,20,1,21,455,476,37,2598,292,3366,86974
4464,9,23,ITA,22,P.A. Trento,46.06893511,11.12123097,13,0,13,547,560,22,4818,405,5783,94533
4465,9,23,ITA,1,Piemonte,45.0732745,7.680687483,163,8,171,2247,2418,95,28000,4157,34575,413848
4466,9,23,ITA,16,Puglia,41.12559576,16.86736689,204,10,214,2008,2222,89,4426,583,7231,274285
4467,9,23,ITA,20,Sardegna,39.21531192,9.110616306,100,21,121,1624,1745,49,1515,145,3405,149069
4468,9,23,ITA,19,Sicilia,38.11569725,13.3623567,230,16,246,2166,2412,89,3519,303,6234,331383
4469,9,23,ITA,9,Toscana,43.76923077,11.25588885,97,24,121,2933,3054,90,9853,1153,14060,467414
4470,9,23,ITA,10,Umbria,43.10675841,12.38824698,30,3,33,435,468,19,1713,85,2266,115748
4471,9,23,ITA,2,Valle d'Aosta,45.73750286,7.320149366,4,0,4,54,58,2,1080,146,1284,19381
4472,9,23,ITA,5,Veneto,45.43490485,12.33845213,139,16,155,3000,3155,150,20832,2167,26154,711874
4473,9,24,ITA,13,Abruzzo,42.35122196,13.39843823,50,4,54,716,770,17,3019,477,4266,123127
4474,9,24,ITA,17,Basilicata,40.63947052,15.80514834,13,1,14,182,196,9,454,28,678,68007
4475,9,24,ITA,18,Calabria,38.90597598,16.59440194,29,4,33,467,500,9,1298,98,1896,189767
4476,9,24,ITA,15,Campania,40.83956555,14.25084984,371,25,396,4761,5157,195,5488,457,11102,355075
4477,9,24,ITA,8,Emilia-Romagna,44.49436681,11.3417208,192,20,212,4415,4627,99,25604,4480,34711,643017
4478,9,24,ITA,6,Friuli Venezia Giulia,45.6494354,13.76813649,21,6,27,680,707,28,3432,350,4489,175810
4479,9,24,ITA,12,Lazio,41.89277044,12.48366722,544,35,579,5768,6347,230,7956,902,15205,686623
4480,9,24,ITA,7,Liguria,44.41149315,8.9326992,153,18,171,1483,1654,102,9621,1596,12871,158350
4481,9,24,ITA,3,Lombardia,45.46679409,9.190347404,303,31,334,8714,9048,229,79472,16935,105455,1252897
4482,9,24,ITA,11,Marche,43.61675973,13.5188753,25,3,28,672,700,17,6129,989,7818,140335
4483,9,24,ITA,14,Molise,41.55774754,14.65916051,3,1,4,129,133,4,471,23,627,39412
4484,9,24,ITA,21,P.A. Bolzano,46.49933453,11.35662422,20,1,21,464,485,20,2609,292,3386,87710
4485,9,24,ITA,22,P.A. Trento,46.06893511,11.12123097,14,0,14,535,549,23,4852,405,5806,94954
4486,9,24,ITA,1,Piemonte,45.0732745,7.680687483,165,9,174,2288,2462,104,28059,4158,34679,417396
4487,9,24,ITA,16,Puglia,41.12559576,16.86736689,207,10,217,2046,2263,73,4455,586,7304,276895
4488,9,24,ITA,20,Sardegna,39.21531192,9.110616306,112,18,130,1632,1762,66,1561,148,3471,151015
4489,9,24,ITA,19,Sicilia,38.11569725,13.3623567,237,16,253,2208,2461,125,3594,304,6359,334504
4490,9,24,ITA,9,Toscana,43.76923077,11.25588885,95,24,119,3037,3156,156,9907,1153,14216,472376
4491,9,24,ITA,10,Umbria,43.10675841,12.38824698,30,3,33,442,475,29,1735,85,2295,116814
4492,9,24,ITA,2,Valle d'Aosta,45.73750286,7.320149366,3,0,3,53,56,3,1085,146,1287,19525
4493,9,24,ITA,5,Veneto,45.43490485,12.33845213,144,17,161,3111,3272,248,20961,2169,26402,717052
4494,9,25,ITA,13,Abruzzo,42.35122196,13.39843823,58,5,63,754,817,51,3023,477,4317,124138
4495,9,25,ITA,17,Basilicata,40.63947052,15.80514834,13,1,14,191,205,13,458,28,691,68857
4496,9,25,ITA,18,Calabria,38.90597598,16.59440194,32,3,35,473,508,10,1300,98,1906,191675
4497,9,25,ITA,15,Campania,40.83956555,14.25084984,382,27,409,4849,5258,253,5638,459,11355,362048
4498,9,25,ITA,8,Emilia-Romagna,44.49436681,11.3417208,189,18,207,4444,4651,122,25701,4481,34833,647139
4499,9,25,ITA,6,Friuli Venezia Giulia,45.6494354,13.76813649,17,6,23,690,713,37,3463,350,4526,177070
4500,9,25,ITA,12,Lazio,41.89277044,12.48366722,563,36,599,5892,6491,230,8040,904,15435,695956
4501,9,25,ITA,7,Liguria,44.41149315,8.9326992,145,17,162,1564,1726,73,9621,1597,12944,159717
4502,9,25,ITA,3,Lombardia,45.46679409,9.190347404,300,30,330,8841,9171,277,79624,16937,105732,1265754
4503,9,25,ITA,11,Marche,43.61675973,13.5188753,22,2,24,697,721,33,6140,990,7851,141222
4504,9,25,ITA,14,Molise,41.55774754,14.65916051,3,1,4,129,133,5,476,23,632,39893
4505,9,25,ITA,21,P.A. Bolzano,46.49933453,11.35662422,20,1,21,493,514,52,2632,292,3438,88792
4506,9,25,ITA,22,P.A. Trento,46.06893511,11.12123097,13,0,13,535,548,23,4876,405,5829,95829
4507,9,25,ITA,1,Piemonte,45.0732745,7.680687483,163,9,172,2330,2502,120,28138,4159,34799,420303
4508,9,25,ITA,16,Puglia,41.12559576,16.86736689,208,10,218,2091,2309,90,4498,587,7394,279402
4509,9,25,ITA,20,Sardegna,39.21531192,9.110616306,112,19,131,1653,1784,57,1596,148,3528,152652
4510,9,25,ITA,19,Sicilia,38.11569725,13.3623567,235,13,248,2282,2530,107,3630,306,6466,337774
4511,9,25,ITA,9,Toscana,43.76923077,11.25588885,87,24,111,3150,3261,139,9938,1156,14355,477064
4512,9,25,ITA,10,Umbria,43.10675841,12.38824698,32,3,35,450,485,23,1748,85,2318,117862
4513,9,25,ITA,2,Valle d'Aosta,45.73750286,7.320149366,3,0,3,52,55,1,1087,146,1288,19587
4514,9,25,ITA,5,Veneto,45.43490485,12.33845213,140,19,159,3177,3336,196,21089,2173,26598,721936
4515,9,26,ITA,13,Abruzzo,42.35122196,13.39843823,54,5,59,762,821,16,3035,477,4333,124985
4516,9,26,ITA,17,Basilicata,40.63947052,15.80514834,14,1,15,214,229,25,459,28,716,69687
4517,9,26,ITA,18,Calabria,38.90597598,16.59440194,30,2,32,481,513,15,1308,100,1921,193439
4518,9,26,ITA,15,Campania,40.83956555,14.25084984,325,29,354,5127,5481,274,5688,460,11629,367291
4519,9,26,ITA,8,Emilia-Romagna,44.49436681,11.3417208,200,17,217,4500,4717,99,25734,4481,34932,651887
4520,9,26,ITA,6,Friuli Venezia Giulia,45.6494354,13.76813649,18,6,24,694,718,54,3512,350,4580,178499
4521,9,26,ITA,12,Lazio,41.89277044,12.48366722,591,35,626,6041,6667,219,8081,906,15654,703206
4522,9,26,ITA,7,Liguria,44.41149315,8.9326992,136,19,155,1582,1737,97,9705,1599,13041,161282
4523,9,26,ITA,3,Lombardia,45.46679409,9.190347404,312,30,342,8745,9087,256,79960,16941,105988,1278033
4524,9,26,ITA,11,Marche,43.61675973,13.5188753,23,2,25,716,741,26,6146,990,7877,142155
4525,9,26,ITA,14,Molise,41.55774754,14.65916051,4,1,5,130,135,5,479,23,637,40259
4526,9,26,ITA,21,P.A. Bolzano,46.49933453,11.35662422,26,0,26,514,540,29,2635,292,3467,89488
4527,9,26,ITA,22,P.A. Trento,46.06893511,11.12123097,14,0,14,549,563,51,4912,405,5880,96818
4528,9,26,ITA,1,Piemonte,45.0732745,7.680687483,164,10,174,2389,2563,107,28183,4160,34906,423689
4529,9,26,ITA,16,Puglia,41.12559576,16.86736689,203,11,214,2123,2337,51,4518,590,7445,282195
4530,9,26,ITA,20,Sardegna,39.21531192,9.110616306,109,18,127,1709,1836,63,1607,148,3591,154219
4531,9,26,ITA,19,Sicilia,38.11569725,13.3623567,255,13,268,2315,2583,110,3687,306,6576,342008
4532,9,26,ITA,9,Toscana,43.76923077,11.25588885,84,24,108,3219,3327,110,9981,1157,14465,481455
4533,9,26,ITA,10,Umbria,43.10675841,12.38824698,34,3,37,463,500,35,1768,85,2353,118947
4534,9,26,ITA,2,Valle d'Aosta,45.73750286,7.320149366,3,0,3,63,66,11,1087,146,1299,19697
4535,9,26,ITA,5,Veneto,45.43490485,12.33845213,147,21,168,3264,3432,216,21208,2174,26814,727456
4536,9,27,ITA,13,Abruzzo,42.35122196,13.39843823,50,5,55,807,862,47,3040,478,4380,126265
4537,9,27,ITA,17,Basilicata,40.63947052,15.80514834,13,1,14,252,266,47,468,29,763,70206
4538,9,27,ITA,18,Calabria,38.90597598,16.59440194,35,2,37,507,544,31,1308,100,1952,195309
4539,9,27,ITA,15,Campania,40.83956555,14.25084984,400,30,430,5160,5590,245,5824,460,11874,371640
4540,9,27,ITA,8,Emilia-Romagna,44.49436681,11.3417208,201,15,216,4466,4682,96,25864,4482,35028,655624
4541,9,27,ITA,6,Friuli Venezia Giulia,45.6494354,13.76813649,18,6,24,696,720,28,3537,351,4608,179595
4542,9,27,ITA,12,Lazio,41.89277044,12.48366722,610,38,648,6161,6809,181,8119,907,15835,710057
4543,9,27,ITA,7,Liguria,44.41149315,8.9326992,137,22,159,1579,1738,45,9749,1599,13086,162174
4544,9,27,ITA,3,Lombardia,45.46679409,9.190347404,302,31,333,8904,9237,216,80021,16946,106204,1288690
4545,9,27,ITA,11,Marche,43.61675973,13.5188753,20,2,22,738,760,24,6151,990,7901,143076
4546,9,27,ITA,14,Molise,41.55774754,14.65916051,2,1,3,138,141,7,479,24,644,40403
4547,9,27,ITA,21,P.A. Bolzano,46.49933453,11.35662422,26,0,26,521,547,22,2650,292,3489,90172
4548,9,27,ITA,22,P.A. Trento,46.06893511,11.12123097,12,0,12,586,598,42,4919,405,5922,97509
4549,9,27,ITA,1,Piemonte,45.0732745,7.680687483,166,10,176,2457,2633,132,28244,4161,35038,426733
4550,9,27,ITA,16,Puglia,41.12559576,16.86736689,210,12,222,2182,2404,76,4527,590,7521,283877
4551,9,27,ITA,20,Sardegna,39.21531192,9.110616306,110,18,128,1836,1964,139,1617,149,3730,156237
4552,9,27,ITA,19,Sicilia,38.11569725,13.3623567,268,14,282,2377,2659,107,3716,308,6683,345016
4553,9,27,ITA,9,Toscana,43.76923077,11.25588885,82,23,105,3302,3407,101,10002,1157,14566,486576
4554,9,27,ITA,10,Umbria,43.10675841,12.38824698,33,3,36,465,501,21,1788,85,2374,120300
4555,9,27,ITA,2,Valle d'Aosta,45.73750286,7.320149366,3,0,3,63,66,0,1087,146,1299,19826
4556,9,27,ITA,5,Veneto,45.43490485,12.33845213,148,21,169,3321,3490,159,21307,2176,26973,731147
4557,9,28,ITA,13,Abruzzo,42.35122196,13.39843823,54,4,58,799,857,4,3048,479,4384,126392
4558,9,28,ITA,17,Basilicata,40.63947052,15.80514834,13,1,14,259,273,7,468,29,770,70392
4559,9,28,ITA,18,Calabria,38.90597598,16.59440194,36,2,38,508,546,5,1311,100,1957,196284
4560,9,28,ITA,15,Campania,40.83956555,14.25084984,412,30,442,5298,5740,295,5968,461,12169,374216
4561,9,28,ITA,8,Emilia-Romagna,44.49436681,11.3417208,201,15,216,4469,4685,85,25946,4482,35113,658254
4562,9,28,ITA,6,Friuli Venezia Giulia,45.6494354,13.76813649,18,6,24,697,721,2,3538,351,4610,179938
4563,9,28,ITA,12,Lazio,41.89277044,12.48366722,640,41,681,6240,6921,211,8215,910,16046,716730
4564,9,28,ITA,7,Liguria,44.41149315,8.9326992,145,24,169,1601,1770,109,9825,1600,13195,163180
4565,9,28,ITA,3,Lombardia,45.46679409,9.190347404,306,31,337,8997,9334,119,80041,16948,106323,1293542
4566,9,28,ITA,11,Marche,43.61675973,13.5188753,25,4,29,733,762,5,6154,990,7906,143293
4567,9,28,ITA,14,Molise,41.55774754,14.65916051,4,1,5,132,137,4,487,24,648,41105
4568,9,28,ITA,21,P.A. Bolzano,46.49933453,11.35662422,26,0,26,534,560,25,2662,292,3514,90576
4569,9,28,ITA,22,P.A. Trento,46.06893511,11.12123097,11,0,11,604,615,20,4921,406,5942,97622
4570,9,28,ITA,1,Piemonte,45.0732745,7.680687483,180,12,192,2492,2684,94,28287,4161,35132,428535
4571,9,28,ITA,16,Puglia,41.12559576,16.86736689,214,15,229,2190,2419,90,4600,592,7611,285597
4572,9,28,ITA,20,Sardegna,39.21531192,9.110616306,109,17,126,1843,1969,37,1648,150,3767,157411
4573,9,28,ITA,19,Sicilia,38.11569725,13.3623567,294,15,309,2434,2743,102,3733,309,6785,346506
4574,9,28,ITA,9,Toscana,43.76923077,11.25588885,93,22,115,3278,3393,85,10098,1160,14651,489436
4575,9,28,ITA,10,Umbria,43.10675841,12.38824698,38,3,41,467,508,11,1792,85,2385,120628
4576,9,28,ITA,2,Valle d'Aosta,45.73750286,7.320149366,3,0,3,62,65,1,1089,146,1300,19888
4577,9,28,ITA,5,Veneto,45.43490485,12.33845213,155,21,176,3445,3621,183,21359,2176,27156,733252
4578,9,29,ITA,13,Abruzzo,42.35122196,13.39843823,52,4,56,809,865,14,3051,481,4397,126999
4579,9,29,ITA,17,Basilicata,40.63947052,15.80514834,13,1,14,262,276,6,471,29,776,71333
4580,9,29,ITA,18,Calabria,38.90597598,16.59440194,34,2,36,508,544,10,1323,100,1967,197671
4581,9,29,ITA,15,Campania,40.83956555,14.25084984,417,35,452,5513,5965,286,6027,463,12455,378937
4582,9,29,ITA,8,Emilia-Romagna,44.49436681,11.3417208,204,14,218,4492,4710,97,26016,4484,35210,662825
4583,9,29,ITA,6,Friuli Venezia Giulia,45.6494354,13.76813649,21,6,27,697,724,28,3563,351,4638,180925
4584,9,29,ITA,12,Lazio,41.89277044,12.48366722,674,45,719,6330,7049,219,8303,913,16265,724000
4585,9,29,ITA,7,Liguria,44.41149315,8.9326992,143,22,165,1553,1718,89,9963,1603,13284,164500
4586,9,29,ITA,3,Lombardia,45.46679409,9.190347404,315,33,348,8751,9099,203,80476,16951,106526,1303500
4587,9,29,ITA,11,Marche,43.61675973,13.5188753,26,3,29,752,781,26,6161,990,7932,144152
4588,9,29,ITA,14,Molise,41.55774754,14.65916051,5,1,6,129,135,1,490,24,649,41224
4589,9,29,ITA,21,P.A. Bolzano,46.49933453,11.35662422,28,0,28,538,566,8,2664,292,3522,91062
4590,9,29,ITA,22,P.A. Trento,46.06893511,11.12123097,11,0,11,576,587,13,4962,406,5955,98077
4591,9,29,ITA,1,Piemonte,45.0732745,7.680687483,193,12,205,2527,2732,100,28337,4163,35232,431233
4592,9,29,ITA,16,Puglia,41.12559576,16.86736689,210,14,224,2209,2433,76,4662,592,7687,288503
4593,9,29,ITA,20,Sardegna,39.21531192,9.110616306,102,19,121,1910,2031,82,1667,151,3849,158909
4594,9,29,ITA,19,Sicilia,38.11569725,13.3623567,293,16,309,2478,2787,163,3851,310,6948,350664
4595,9,29,ITA,9,Toscana,43.76923077,11.25588885,97,20,117,3251,3368,56,10175,1164,14707,492445
4596,9,29,ITA,10,Umbria,43.10675841,12.38824698,39,3,42,478,520,23,1803,85,2408,121933
4597,9,29,ITA,2,Valle d'Aosta,45.73750286,7.320149366,4,0,4,65,69,8,1093,146,1308,19979
4598,9,29,ITA,5,Veneto,45.43490485,12.33845213,167,21,188,3483,3671,140,21448,2177,27296,737524
4599,9,30,ITA,13,Abruzzo,42.35122196,13.39843823,52,5,57,824,881,23,3057,481,4419,128012
4600,9,30,ITA,17,Basilicata,40.63947052,15.80514834,11,2,13,294,307,32,472,29,808,72216
4601,9,30,ITA,18,Calabria,38.90597598,16.59440194,33,2,35,520,555,18,1330,100,1985,199568
4602,9,30,ITA,15,Campania,40.83956555,14.25084984,414,39,453,5660,6113,287,6166,463,12742,383899
4603,9,30,ITA,8,Emilia-Romagna,44.49436681,11.3417208,205,14,219,4434,4653,101,26174,4484,35311,667137
4604,9,30,ITA,6,Friuli Venezia Giulia,45.6494354,13.76813649,19,6,25,693,718,28,3597,351,4666,182145
4605,9,30,ITA,12,Lazio,41.89277044,12.48366722,659,47,706,6442,7148,210,8409,918,16475,732123
4606,9,30,ITA,7,Liguria,44.41149315,8.9326992,143,22,165,1574,1739,51,9992,1604,13335,166142
4607,9,30,ITA,3,Lombardia,45.46679409,9.190347404,306,34,340,8720,9060,201,80712,16955,106727,1315230
4608,9,30,ITA,11,Marche,43.61675973,13.5188753,28,2,30,765,795,23,6170,990,7955,144940
4609,9,30,ITA,14,Molise,41.55774754,14.65916051,4,0,4,129,133,6,498,24,655,41728
4610,9,30,ITA,21,P.A. Bolzano,46.49933453,11.35662422,28,0,28,533,561,17,2686,292,3539,91761
4611,9,30,ITA,22,P.A. Trento,46.06893511,11.12123097,14,0,14,553,567,37,5019,406,5992,99092
4612,9,30,ITA,1,Piemonte,45.0732745,7.680687483,196,12,208,2636,2844,170,28394,4164,35402,434855
4613,9,30,ITA,16,Puglia,41.12559576,16.86736689,218,11,229,2287,2516,99,4675,595,7786,291519
4614,9,30,ITA,20,Sardegna,39.21531192,9.110616306,101,19,120,1941,2061,51,1685,154,3900,161097
4615,9,30,ITA,19,Sicilia,38.11569725,13.3623567,301,19,320,2546,2866,170,3941,311,7118,354475
4616,9,30,ITA,9,Toscana,43.76923077,11.25588885,97,22,119,3283,3402,120,10261,1164,14827,497351
4617,9,30,ITA,10,Umbria,43.10675841,12.38824698,39,3,42,495,537,46,1832,85,2454,122979
4618,9,30,ITA,2,Valle d'Aosta,45.73750286,7.320149366,6,0,6,69,75,6,1093,146,1314,20125
4619,9,30,ITA,5,Veneto,45.43490485,12.33845213,173,21,194,3538,3732,155,21541,2178,27451,742361
4620,10,1,ITA,13,Abruzzo,42.35122196,13.39843823,52,5,57,852,909,30,3059,481,4449,129248
4621,10,1,ITA,17,Basilicata,40.63947052,15.80514834,11,2,13,325,338,33,474,29,841,73155
4622,10,1,ITA,18,Calabria,38.90597598,16.59440194,32,2,34,503,537,17,1365,100,2002,201540
4623,10,1,ITA,15,Campania,40.83956555,14.25084984,421,38,459,5937,6396,390,6273,463,13132,391374
4624,10,1,ITA,8,Emilia-Romagna,44.49436681,11.3417208,206,14,220,4434,4654,103,26276,4484,35414,670418
4625,10,1,ITA,6,Friuli Venezia Giulia,45.6494354,13.76813649,20,4,24,735,759,57,3613,351,4723,183898
4626,10,1,ITA,12,Lazio,41.89277044,12.48366722,666,49,715,6628,7343,265,8474,923,16740,740268
4627,10,1,ITA,7,Liguria,44.41149315,8.9326992,152,21,173,1598,1771,111,10067,1608,13446,167855
4628,10,1,ITA,3,Lombardia,45.46679409,9.190347404,298,35,333,8834,9167,324,80924,16960,107051,1331274
4629,10,1,ITA,11,Marche,43.61675973,13.5188753,24,6,30,783,813,28,6180,990,7983,145986
4630,10,1,ITA,14,Molise,41.55774754,14.65916051,4,0,4,130,134,1,498,24,656,41971
4631,10,1,ITA,21,P.A. Bolzano,46.49933453,11.35662422,28,0,28,554,582,29,2694,292,3568,92681
4632,10,1,ITA,22,P.A. Trento,46.06893511,11.12123097,15,0,15,579,594,48,5040,406,6040,99722
4633,10,1,ITA,1,Piemonte,45.0732745,7.680687483,203,12,215,2692,2907,110,28440,4165,35512,436125
4634,10,1,ITA,16,Puglia,41.12559576,16.86736689,217,14,231,2376,2607,114,4697,596,7900,294298
4635,10,1,ITA,20,Sardegna,39.21531192,9.110616306,110,20,130,2006,2136,96,1705,155,3996,162894
4636,10,1,ITA,19,Sicilia,38.11569725,13.3623567,307,20,327,2609,2936,156,4026,312,7274,358336
4637,10,1,ITA,9,Toscana,43.76923077,11.25588885,106,22,128,3340,3468,144,10338,1165,14971,502556
4638,10,1,ITA,10,Umbria,43.10675841,12.38824698,38,3,41,521,562,46,1853,85,2500,124094
4639,10,1,ITA,2,Valle d'Aosta,45.73750286,7.320149366,7,0,7,62,69,1,1100,146,1315,20265
4640,10,1,ITA,5,Veneto,45.43490485,12.33845213,180,24,204,3761,3965,445,21748,2183,27896,748630
4641,10,2,ITA,13,Abruzzo,42.35122196,13.39843823,58,6,64,874,938,49,3079,481,4498,130591
4642,10,2,ITA,17,Basilicata,40.63947052,15.80514834,11,2,13,332,345,16,482,30,857,74088
4643,10,2,ITA,18,Calabria,38.90597598,16.59440194,34,1,35,503,538,18,1382,100,2020,203282
4644,10,2,ITA,15,Campania,40.83956555,14.25084984,439,39,478,6267,6745,392,6315,464,13524,397526
4645,10,2,ITA,8,Emilia-Romagna,44.49436681,11.3417208,201,11,212,4465,4677,163,26416,4484,35577,676766
4646,10,2,ITA,6,Friuli Venezia Giulia,45.6494354,13.76813649,18,2,20,773,793,66,3643,353,4789,185748
4647,10,2,ITA,12,Lazio,41.89277044,12.48366722,678,49,727,6820,7547,264,8529,928,17004,749852
4648,10,2,ITA,7,Liguria,44.41149315,8.9326992,161,23,184,1645,1829,140,10149,1608,13586,169760
4649,10,2,ITA,3,Lombardia,45.46679409,9.190347404,302,39,341,8825,9166,307,81228,16964,107358,1343544
4650,10,2,ITA,11,Marche,43.61675973,13.5188753,25,4,29,815,844,42,6191,990,8025,147169
4651,10,2,ITA,14,Molise,41.55774754,14.65916051,5,0,5,126,131,4,505,24,660,42437
4652,10,2,ITA,21,P.A. Bolzano,46.49933453,11.35662422,28,0,28,559,587,21,2710,292,3589,93443
4653,10,2,ITA,22,P.A. Trento,46.06893511,11.12123097,16,0,16,571,587,39,5086,406,6079,100451
4654,10,2,ITA,1,Piemonte,45.0732745,7.680687483,217,13,230,2830,3060,219,28505,4166,35731,438901
4655,10,2,ITA,16,Puglia,41.12559576,16.86736689,223,13,236,2427,2663,72,4712,597,7972,296760
4656,10,2,ITA,20,Sardegna,39.21531192,9.110616306,106,21,127,2027,2154,60,1747,155,4056,164505
4657,10,2,ITA,19,Sicilia,38.11569725,13.3623567,303,21,324,2724,3048,140,4052,314,7414,362142
4658,10,2,ITA,9,Toscana,43.76923077,11.25588885,103,24,127,3504,3631,223,10398,1165,15194,508398
4659,10,2,ITA,10,Umbria,43.10675841,12.38824698,39,4,43,567,610,62,1867,85,2562,125136
4660,10,2,ITA,2,Valle d'Aosta,45.73750286,7.320149366,8,0,8,69,77,11,1103,146,1326,20378
4661,10,2,ITA,5,Veneto,45.43490485,12.33845213,167,22,189,3838,4027,191,21871,2189,28087,757440
4662,10,3,ITA,13,Abruzzo,42.35122196,13.39843823,66,6,72,890,962,42,3097,481,4540,131710
4663,10,3,ITA,17,Basilicata,40.63947052,15.80514834,15,2,17,370,387,49,486,33,906,75517
4664,10,3,ITA,18,Calabria,38.90597598,16.59440194,36,2,38,520,558,24,1386,100,2044,205184
4665,10,3,ITA,15,Campania,40.83956555,14.25084984,434,40,474,6568,7042,401,6418,465,13925,403167
4666,10,3,ITA,8,Emilia-Romagna,44.49436681,11.3417208,200,11,211,4579,4790,167,26468,4485,35743,680394
4667,10,3,ITA,6,Friuli Venezia Giulia,45.6494354,13.76813649,17,5,22,806,828,51,3659,353,4840,187109
4668,10,3,ITA,12,Lazio,41.89277044,12.48366722,711,47,758,6967,7725,261,8607,933,17265,759903
4669,10,3,ITA,7,Liguria,44.41149315,8.9326992,167,21,188,1672,1860,162,10279,1609,13748,171959
4670,10,3,ITA,3,Lombardia,45.46679409,9.190347404,293,42,335,8827,9162,393,81620,16969,107751,1355640
4671,10,3,ITA,11,Marche,43.61675973,13.5188753,23,6,29,867,896,59,6197,991,8084,148490
4672,10,3,ITA,14,Molise,41.55774754,14.65916051,3,0,3,125,128,0,507,25,660,42882
4673,10,3,ITA,21,P.A. Bolzano,46.49933453,11.35662422,28,0,28,576,604,24,2717,292,3613,94145
4674,10,3,ITA,22,P.A. Trento,46.06893511,11.12123097,16,0,16,602,618,62,5117,406,6141,101101
4675,10,3,ITA,1,Piemonte,45.0732745,7.680687483,214,12,226,3051,3277,279,28567,4166,36010,442510
4676,10,3,ITA,16,Puglia,41.12559576,16.86736689,226,12,238,2523,2761,111,4724,598,8083,299404
4677,10,3,ITA,20,Sardegna,39.21531192,9.110616306,113,21,134,2052,2186,62,1777,155,4118,166214
4678,10,3,ITA,19,Sicilia,38.11569725,13.3623567,322,20,342,2829,3171,182,4108,317,7596,366048
4679,10,3,ITA,9,Toscana,43.76923077,11.25588885,99,24,123,3667,3790,197,10435,1166,15391,514176
4680,10,3,ITA,10,Umbria,43.10675841,12.38824698,41,5,46,588,634,42,1885,85,2604,126315
4681,10,3,ITA,2,Valle d'Aosta,45.73750286,7.320149366,7,0,7,68,75,0,1105,146,1326,20476
4682,10,3,ITA,5,Veneto,45.43490485,12.33845213,174,21,195,3917,4112,276,22058,2193,28363,765605
4683,10,4,ITA,13,Abruzzo,42.35122196,13.39843823,70,6,76,919,995,37,3101,481,4577,132948
4684,10,4,ITA,17,Basilicata,40.63947052,15.80514834,15,2,17,373,390,14,497,33,920,75915
4685,10,4,ITA,18,Calabria,38.90597598,16.59440194,36,2,38,537,575,19,1387,101,2063,206980
4686,10,4,ITA,15,Campania,40.83956555,14.25084984,450,41,491,6909,7400,412,6472,465,14337,408931
4687,10,4,ITA,8,Emilia-Romagna,44.49436681,11.3417208,212,11,223,4731,4954,179,26482,4486,35922,684859
4688,10,4,ITA,6,Friuli Venezia Giulia,45.6494354,13.76813649,18,5,23,828,851,50,3686,353,4890,188339
4689,10,4,ITA,12,Lazio,41.89277044,12.48366722,737,48,785,7148,7933,244,8637,939,17509,768942
4690,10,4,ITA,7,Liguria,44.41149315,8.9326992,167,23,190,1687,1877,121,10382,1610,13869,173211
4691,10,4,ITA,3,Lombardia,45.46679409,9.190347404,296,39,335,9026,9361,314,81733,16971,108065,1365206
4692,10,4,ITA,11,Marche,43.61675973,13.5188753,24,6,30,911,941,59,6210,992,8143,149612
4693,10,4,ITA,14,Molise,41.55774754,14.65916051,2,0,2,139,141,15,509,25,675,43376
4694,10,4,ITA,21,P.A. Bolzano,46.49933453,11.35662422,28,0,28,588,616,32,2737,292,3645,94635
4695,10,4,ITA,22,P.A. Trento,46.06893511,11.12123097,17,0,17,612,629,34,5140,406,6175,101675
4696,10,4,ITA,1,Piemonte,45.0732745,7.680687483,216,13,229,3141,3370,173,28646,4167,36183,446474
4697,10,4,ITA,16,Puglia,41.12559576,16.86736689,231,13,244,2653,2897,151,4739,598,8234,301067
4698,10,4,ITA,20,Sardegna,39.21531192,9.110616306,114,20,134,2145,2279,111,1794,156,4229,167736
4699,10,4,ITA,19,Sicilia,38.11569725,13.3623567,329,24,353,2894,3247,85,4115,319,7681,368405
4700,10,4,ITA,9,Toscana,43.76923077,11.25588885,99,26,125,3837,3962,188,10451,1166,15579,519910
4701,10,4,ITA,10,Umbria,43.10675841,12.38824698,42,4,46,649,695,72,1895,86,2676,127485
4702,10,4,ITA,2,Valle d'Aosta,45.73750286,7.320149366,6,0,6,75,81,7,1106,146,1333,20588
4703,10,4,ITA,5,Veneto,45.43490485,12.33845213,178,20,198,4037,4235,261,22195,2194,28624,771021
4704,10,5,ITA,13,Abruzzo,42.35122196,13.39843823,72,7,79,938,1017,30,3108,482,4607,133682
4705,10,5,ITA,17,Basilicata,40.63947052,15.80514834,30,2,32,371,403,14,498,33,934,76055
4706,10,5,ITA,18,Calabria,38.90597598,16.59440194,37,2,39,544,583,23,1402,101,2086,208340
4707,10,5,ITA,15,Campania,40.83956555,14.25084984,463,43,506,7203,7709,431,6593,466,14768,412392
4708,10,5,ITA,8,Emilia-Romagna,44.49436681,11.3417208,213,11,224,4822,5046,167,26556,4487,36089,686918
4709,10,5,ITA,6,Friuli Venezia Giulia,45.6494354,13.76813649,23,5,28,840,868,21,3690,353,4911,188881
4710,10,5,ITA,12,Lazio,41.89277044,12.48366722,764,48,812,7330,8142,248,8671,944,17757,778041
4711,10,5,ITA,7,Liguria,44.41149315,8.9326992,180,24,204,1703,1907,107,10459,1610,13976,174024
4712,10,5,ITA,3,Lombardia,45.46679409,9.190347404,305,41,346,9186,9532,251,81811,16973,108316,1370079
4713,10,5,ITA,11,Marche,43.61675973,13.5188753,28,6,34,920,954,22,6219,992,8165,150061
4714,10,5,ITA,14,Molise,41.55774754,14.65916051,3,0,3,134,137,2,515,25,677,43575
4715,10,5,ITA,21,P.A. Bolzano,46.49933453,11.35662422,21,0,21,606,627,17,2743,292,3662,94956
4716,10,5,ITA,22,P.A. Trento,46.06893511,11.12123097,17,0,17,633,650,49,5168,406,6224,102111
4717,10,5,ITA,1,Piemonte,45.0732745,7.680687483,273,15,288,3135,3423,129,28721,4168,36312,447344
4718,10,5,ITA,16,Puglia,41.12559576,16.86736689,239,14,253,2703,2956,83,4762,599,8317,302788
4719,10,5,ITA,20,Sardegna,39.21531192,9.110616306,116,19,135,2191,2326,88,1835,156,4317,169073
4720,10,5,ITA,19,Sicilia,38.11569725,13.3623567,361,28,389,2969,3358,128,4130,321,7809,370087
4721,10,5,ITA,9,Toscana,43.76923077,11.25588885,112,32,144,3921,4065,185,10531,1168,15764,523569
4722,10,5,ITA,10,Umbria,43.10675841,12.38824698,42,5,47,659,706,19,1903,86,2695,127714
4723,10,5,ITA,2,Valle d'Aosta,45.73750286,7.320149366,6,1,7,86,93,13,1107,146,1346,20687
4724,10,5,ITA,5,Veneto,45.43490485,12.33845213,182,20,202,4199,4401,230,22259,2194,28854,773489
4725,10,6,ITA,13,Abruzzo,42.35122196,13.39843823,81,6,87,971,1058,48,3113,484,4655,134677
4726,10,6,ITA,17,Basilicata,40.63947052,15.80514834,30,2,32,371,403,4,502,33,938,77079
4727,10,6,ITA,18,Calabria,38.90597598,16.59440194,38,1,39,546,585,23,1422,102,2109,210222
4728,10,6,ITA,15,Campania,40.83956555,14.25084984,488,47,535,7442,7977,395,6718,468,15163,416074
4729,10,6,ITA,8,Emilia-Romagna,44.49436681,11.3417208,212,13,225,4929,5154,172,26617,4490,36261,691551
4730,10,6,ITA,6,Friuli Venezia Giulia,45.6494354,13.76813649,24,5,29,879,908,51,3699,355,4962,190029
4731,10,6,ITA,12,Lazio,41.89277044,12.48366722,774,44,818,7472,8290,275,8794,948,18032,786768
4732,10,6,ITA,7,Liguria,44.41149315,8.9326992,178,23,201,1724,1925,170,10609,1612,14146,175730
4733,10,6,ITA,3,Lombardia,45.46679409,9.190347404,320,40,360,9149,9509,350,82184,16973,108666,1380719
4734,10,6,ITA,11,Marche,43.61675973,13.5188753,29,6,35,947,982,35,6226,992,8200,150966
4735,10,6,ITA,14,Molise,41.55774754,14.65916051,3,0,3,135,138,6,520,25,683,44119
4736,10,6,ITA,21,P.A. Bolzano,46.49933453,11.35662422,21,0,21,609,630,17,2757,292,3679,95487
4737,10,6,ITA,22,P.A. Trento,46.06893511,11.12123097,22,0,22,641,663,40,5195,406,6264,102600
4738,10,6,ITA,1,Piemonte,45.0732745,7.680687483,293,15,308,3274,3582,259,28819,4170,36571,452847
4739,10,6,ITA,16,Puglia,41.12559576,16.86736689,244,21,265,2726,2991,106,4829,603,8423,306067
4740,10,6,ITA,20,Sardegna,39.21531192,9.110616306,125,19,144,2181,2325,63,1898,157,4380,170991
4741,10,6,ITA,19,Sicilia,38.11569725,13.3623567,368,28,396,3052,3448,198,4237,322,8007,374604
4742,10,6,ITA,9,Toscana,43.76923077,11.25588885,117,28,145,4054,4199,209,10606,1168,15973,528501
4743,10,6,ITA,10,Umbria,43.10675841,12.38824698,45,5,50,698,748,62,1923,86,2757,129274
4744,10,6,ITA,2,Valle d'Aosta,45.73750286,7.320149366,5,1,6,87,93,5,1112,146,1351,20774
4745,10,6,ITA,5,Veneto,45.43490485,12.33845213,208,15,223,4303,4526,189,22319,2198,29043,777300
4746,10,7,ITA,13,Abruzzo,42.35122196,13.39843823,88,6,94,1004,1098,61,3132,485,4715,136225
4747,10,7,ITA,17,Basilicata,40.63947052,15.80514834,35,0,35,379,414,15,504,35,953,77839
4748,10,7,ITA,18,Calabria,38.90597598,16.59440194,37,1,38,553,591,16,1432,102,2125,212223
4749,10,7,ITA,15,Campania,40.83956555,14.25084984,520,52,572,7771,8343,544,6895,469,15707,422215
4750,10,7,ITA,8,Emilia-Romagna,44.49436681,11.3417208,223,14,237,5058,5295,193,26668,4491,36454,698835
4751,10,7,ITA,6,Friuli Venezia Giulia,45.6494354,13.76813649,26,6,32,913,945,72,3734,355,5034,192089
4752,10,7,ITA,12,Lazio,41.89277044,12.48366722,808,48,856,7724,8580,357,8855,954,18389,795451
4753,10,7,ITA,7,Liguria,44.41149315,8.9326992,196,24,220,1812,2032,176,10676,1614,14322,177511
4754,10,7,ITA,3,Lombardia,45.46679409,9.190347404,339,40,379,9498,9877,520,82331,16978,109186,1395667
4755,10,7,ITA,11,Marche,43.61675973,13.5188753,31,5,36,1016,1052,84,6240,992,8284,152490
4756,10,7,ITA,14,Molise,41.55774754,14.65916051,4,0,4,134,138,1,521,25,684,44539
4757,10,7,ITA,21,P.A. Bolzano,46.49933453,11.35662422,21,1,22,645,667,55,2775,292,3734,96289
4758,10,7,ITA,22,P.A. Trento,46.06893511,11.12123097,18,0,18,631,649,32,5241,406,6296,102992
4759,10,7,ITA,1,Piemonte,45.0732745,7.680687483,297,15,312,3412,3724,287,28962,4172,36858,456021
4760,10,7,ITA,16,Puglia,41.12559576,16.86736689,251,23,274,2859,3133,196,4883,603,8619,309260
4761,10,7,ITA,20,Sardegna,39.21531192,9.110616306,128,19,147,2243,2390,101,1931,160,4481,172673
4762,10,7,ITA,19,Sicilia,38.11569725,13.3623567,375,30,405,3144,3549,213,4345,326,8220,378610
4763,10,7,ITA,9,Toscana,43.76923077,11.25588885,123,28,151,4279,4430,300,10673,1170,16273,535058
4764,10,7,ITA,10,Umbria,43.10675841,12.38824698,44,8,52,756,808,65,1928,86,2822,135552
4765,10,7,ITA,2,Valle d'Aosta,45.73750286,7.320149366,4,1,5,102,107,15,1113,146,1366,20931
4766,10,7,ITA,5,Veneto,45.43490485,12.33845213,214,16,230,4524,4754,375,22464,2200,29418,784296
4767,10,8,ITA,13,Abruzzo,42.35122196,13.39843823,90,7,97,1055,1152,68,3145,486,4783,137364
4768,10,8,ITA,17,Basilicata,40.63947052,15.80514834,35,0,35,394,429,22,511,35,975,78439
4769,10,8,ITA,18,Calabria,38.90597598,16.59440194,39,1,40,563,603,21,1441,102,2146,214128
4770,10,8,ITA,15,Campania,40.83956555,14.25084984,548,55,603,8347,8950,757,7044,470,16464,430106
4771,10,8,ITA,8,Emilia-Romagna,44.49436681,11.3417208,232,13,245,5179,5424,184,26722,4492,36638,704510
4772,10,8,ITA,6,Friuli Venezia Giulia,45.6494354,13.76813649,23,6,29,991,1020,110,3769,355,5144,194340
4773,10,8,ITA,12,Lazio,41.89277044,12.48366722,821,55,876,7976,8852,359,8936,960,18748,805125
4774,10,8,ITA,7,Liguria,44.41149315,8.9326992,195,28,223,1932,2155,152,10705,1614,14474,179543
4775,10,8,ITA,3,Lombardia,45.46679409,9.190347404,361,41,402,10004,10406,683,82484,16979,109869,1408098
4776,10,8,ITA,11,Marche,43.61675973,13.5188753,34,5,39,1068,1107,66,6251,992,8350,153648
4777,10,8,ITA,14,Molise,41.55774754,14.65916051,6,0,6,136,142,6,523,25,690,45014
4778,10,8,ITA,21,P.A. Bolzano,46.49933453,11.35662422,30,1,31,695,726,69,2785,292,3803,97393
4779,10,8,ITA,22,P.A. Trento,46.06893511,11.12123097,18,0,18,672,690,59,5259,406,6355,103685
4780,10,8,ITA,1,Piemonte,45.0732745,7.680687483,311,16,327,3652,3979,336,29043,4172,37194,459191
4781,10,8,ITA,16,Puglia,41.12559576,16.86736689,278,23,301,3033,3334,248,4929,604,8867,312343
4782,10,8,ITA,20,Sardegna,39.21531192,9.110616306,129,19,148,2322,2470,127,1977,161,4608,174362
4783,10,8,ITA,19,Sicilia,38.11569725,13.3623567,376,33,409,3287,3696,259,4454,329,8479,383416
4784,10,8,ITA,9,Toscana,43.76923077,11.25588885,132,27,159,4590,4749,339,10693,1170,16612,541159
4785,10,8,ITA,10,Umbria,43.10675841,12.38824698,50,8,58,805,863,84,1956,87,2906,131965
4786,10,8,ITA,2,Valle d'Aosta,45.73750286,7.320149366,4,1,5,117,122,18,1116,146,1384,21086
4787,10,8,ITA,5,Veneto,45.43490485,12.33845213,213,19,232,4851,5083,491,22620,2206,29909,790836
4788,10,9,ITA,13,Abruzzo,42.35122196,13.39843823,100,7,107,1142,1249,103,3150,487,4886,138835
4789,10,9,ITA,17,Basilicata,40.63947052,15.80514834,35,0,35,413,448,22,514,35,997,79502
4790,10,9,ITA,18,Calabria,38.90597598,16.59440194,42,1,43,595,638,42,1447,103,2188,216285
4791,10,9,ITA,15,Campania,40.83956555,14.25084984,576,63,639,8958,9597,769,7161,475,17233,437971
4792,10,9,ITA,8,Emilia-Romagna,44.49436681,11.3417208,226,14,240,5369,5609,276,26812,4493,36914,709568
4793,10,9,ITA,6,Friuli Venezia Giulia,45.6494354,13.76813649,23,6,29,1112,1141,146,3794,355,5290,195965
4794,10,9,ITA,12,Lazio,41.89277044,12.48366722,853,57,910,8276,9186,387,8983,966,19135,815474
4795,10,9,ITA,7,Liguria,44.41149315,8.9326992,199,26,225,2050,2275,196,10780,1615,14670,181069
4796,10,9,ITA,3,Lombardia,45.46679409,9.190347404,371,44,415,10713,11128,983,82744,16980,110852,1424471
4797,10,9,ITA,11,Marche,43.61675973,13.5188753,37,3,40,1105,1145,49,6262,992,8399,154836
4798,10,9,ITA,14,Molise,41.55774754,14.65916051,8,0,8,144,152,11,524,25,701,45640
4799,10,9,ITA,21,P.A. Bolzano,46.49933453,11.35662422,35,2,37,760,797,85,2799,292,3888,98176
4800,10,9,ITA,22,P.A. Trento,46.06893511,11.12123097,20,0,20,661,681,39,5307,406,6394,104126
4801,10,9,ITA,1,Piemonte,45.0732745,7.680687483,345,22,367,3943,4310,401,29113,4172,37595,462323
4802,10,9,ITA,16,Puglia,41.12559576,16.86736689,300,23,323,3227,3550,249,4960,606,9116,315837
4803,10,9,ITA,20,Sardegna,39.21531192,9.110616306,133,23,156,2413,2569,134,2012,161,4742,176462
4804,10,9,ITA,19,Sicilia,38.11569725,13.3623567,376,35,411,3490,3901,233,4478,333,8712,387714
4805,10,9,ITA,9,Toscana,43.76923077,11.25588885,140,30,170,4951,5121,483,10801,1173,17095,548458
4806,10,9,ITA,10,Umbria,43.10675841,12.38824698,55,8,63,937,1000,151,1970,87,3057,133522
4807,10,9,ITA,2,Valle d'Aosta,45.73750286,7.320149366,4,2,6,133,139,18,1117,146,1402,21200
4808,10,9,ITA,5,Veneto,45.43490485,12.33845213,208,21,229,5245,5474,595,22821,2209,30504,796159
4809,10,10,ITA,13,Abruzzo,42.35122196,13.39843823,110,7,117,1224,1341,94,3152,487,4980,140150
4810,10,10,ITA,17,Basilicata,40.63947052,15.80514834,36,0,36,439,475,37,524,35,1034,80358
4811,10,10,ITA,18,Calabria,38.90597598,16.59440194,41,1,42,654,696,68,1457,103,2256,218830
4812,10,10,ITA,15,Campania,40.83956555,14.25084984,635,63,698,9493,10191,664,7229,477,17897,446216
4813,10,10,ITA,8,Emilia-Romagna,44.49436681,11.3417208,241,16,257,5719,5976,383,26827,4494,37297,715054
4814,10,10,ITA,6,Friuli Venezia Giulia,45.6494354,13.76813649,23,6,29,1215,1244,126,3817,355,5416,197963
4815,10,10,ITA,12,Lazio,41.89277044,12.48366722,884,57,941,8564,9505,384,9042,972,19519,826222
4816,10,10,ITA,7,Liguria,44.41149315,8.9326992,222,26,248,2198,2446,213,10820,1617,14883,183026
4817,10,10,ITA,3,Lombardia,45.46679409,9.190347404,408,44,452,11570,12022,1140,82988,16982,111992,1438722
4818,10,10,ITA,11,Marche,43.61675973,13.5188753,41,3,44,1159,1203,86,6290,992,8485,156147
4819,10,10,ITA,14,Molise,41.55774754,14.65916051,7,0,7,135,142,10,543,26,711,46155
4820,10,10,ITA,21,P.A. Bolzano,46.49933453,11.35662422,35,2,37,836,873,92,2815,292,3980,99125
4821,10,10,ITA,22,P.A. Trento,46.06893511,11.12123097,19,0,19,668,687,50,5349,408,6444,104720
4822,10,10,ITA,1,Piemonte,45.0732745,7.680687483,354,22,376,4365,4741,499,29179,4174,38094,467397
4823,10,10,ITA,16,Puglia,41.12559576,16.86736689,300,22,322,3389,3711,184,4982,607,9300,319289
4824,10,10,ITA,20,Sardegna,39.21531192,9.110616306,140,25,165,2506,2671,124,2034,161,4866,177776
4825,10,10,ITA,19,Sicilia,38.11569725,13.3623567,387,35,422,3721,4143,285,4519,335,8997,392395
4826,10,10,ITA,9,Toscana,43.76923077,11.25588885,160,30,190,5450,5640,548,10830,1173,17643,556336
4827,10,10,ITA,10,Umbria,43.10675841,12.38824698,56,8,64,1046,1110,132,1991,88,3189,134818
4828,10,10,ITA,2,Valle d'Aosta,45.73750286,7.320149366,6,3,9,171,180,44,1120,146,1446,21356
4829,10,10,ITA,5,Veneto,45.43490485,12.33845213,231,20,251,5581,5832,561,23017,2216,31065,801647
4830,10,11,ITA,13,Abruzzo,42.35122196,13.39843823,116,8,124,1293,1417,77,3153,487,5057,141605
4831,10,11,ITA,17,Basilicata,40.63947052,15.80514834,36,0,36,449,485,13,527,35,1047,81320
4832,10,11,ITA,18,Calabria,38.90597598,16.59440194,41,1,42,688,730,35,1458,103,2291,220526
4833,10,11,ITA,15,Campania,40.83956555,14.25084984,664,61,725,9969,10694,633,7357,479,18530,454679
4834,10,11,ITA,8,Emilia-Romagna,44.49436681,11.3417208,254,23,277,6072,6349,384,26837,4495,37681,719690
4835,10,11,ITA,6,Friuli Venezia Giulia,45.6494354,13.76813649,22,5,27,1296,1323,97,3834,356,5513,198763
4836,10,11,ITA,12,Lazio,41.89277044,12.48366722,911,69,980,8862,9842,371,9072,976,19890,836669
4837,10,11,ITA,7,Liguria,44.41149315,8.9326992,238,26,264,2334,2598,386,11052,1619,15269,184673
4838,10,11,ITA,3,Lombardia,45.46679409,9.190347404,433,48,481,12368,12849,1032,83190,16985,113024,1448672
4839,10,11,ITA,11,Marche,43.61675973,13.5188753,44,6,50,1253,1303,108,6298,992,8593,157585
4840,10,11,ITA,14,Molise,41.55774754,14.65916051,9,0,9,156,165,28,548,26,739,46626
4841,10,11,ITA,21,P.A. Bolzano,46.49933453,11.35662422,35,1,36,904,940,84,2831,293,4064,99917
4842,10,11,ITA,22,P.A. Trento,46.06893511,11.12123097,19,0,19,662,681,39,5394,408,6483,105220
4843,10,11,ITA,1,Piemonte,45.0732745,7.680687483,378,24,402,4654,5056,409,29270,4177,38503,472398
4844,10,11,ITA,16,Puglia,41.12559576,16.86736689,301,21,322,3485,3807,212,5097,608,9512,321156
4845,10,11,ITA,20,Sardegna,39.21531192,9.110616306,140,22,162,2610,2772,143,2072,165,5009,179167
4846,10,11,ITA,19,Sicilia,38.11569725,13.3623567,388,38,426,3975,4401,297,4557,336,9294,395172
4847,10,11,ITA,9,Toscana,43.76923077,11.25588885,186,31,217,5925,6142,517,10844,1174,18160,564468
4848,10,11,ITA,10,Umbria,43.10675841,12.38824698,58,9,67,1169,1236,135,2000,88,3324,136523
4849,10,11,ITA,2,Valle d'Aosta,45.73750286,7.320149366,8,3,11,186,197,18,1121,146,1464,21530
4850,10,11,ITA,5,Veneto,45.43490485,12.33845213,238,24,262,5826,6088,438,23197,2218,31503,806051
4851,10,12,ITA,13,Abruzzo,42.35122196,13.39843823,137,11,148,1384,1532,117,3154,488,5174,142974
4852,10,12,ITA,17,Basilicata,40.63947052,15.80514834,36,0,36,459,495,11,528,35,1058,81450
4853,10,12,ITA,18,Calabria,38.90597598,16.59440194,42,1,43,730,773,53,1467,104,2344,221754
4854,10,12,ITA,15,Campania,40.83956555,14.25084984,685,64,749,10477,11226,662,7487,479,19192,460813
4855,10,12,ITA,8,Emilia-Romagna,44.49436681,11.3417208,284,25,309,6364,6673,337,26849,4496,38018,723741
4856,10,12,ITA,6,Friuli Venezia Giulia,45.6494354,13.76813649,22,5,27,1345,1372,59,3844,356,5572,199799
4857,10,12,ITA,12,Lazio,41.89277044,12.48366722,927,78,1005,9117,10122,395,9179,984,20285,849390
4858,10,12,ITA,7,Liguria,44.41149315,8.9326992,261,24,285,2456,2741,186,11093,1621,15455,185406
4859,10,12,ITA,3,Lombardia,45.46679409,9.190347404,463,50,513,12866,13379,696,83353,16988,113720,1458192
4860,10,12,ITA,11,Marche,43.61675973,13.5188753,50,5,55,1274,1329,37,6309,992,8630,158054
4861,10,12,ITA,14,Molise,41.55774754,14.65916051,9,0,9,155,164,7,556,26,746,47043
4862,10,12,ITA,21,P.A. Bolzano,46.49933453,11.35662422,42,2,44,929,973,45,2843,293,4109,100427
4863,10,12,ITA,22,P.A. Trento,46.06893511,11.12123097,19,0,19,661,680,2,5396,409,6485,105284
4864,10,12,ITA,1,Piemonte,45.0732745,7.680687483,457,22,479,4984,5463,454,29314,4180,38957,476939
4865,10,12,ITA,16,Puglia,41.12559576,16.86736689,307,19,326,3587,3913,157,5142,614,9669,323084
4866,10,12,ITA,20,Sardegna,39.21531192,9.110616306,157,23,180,2679,2859,129,2113,166,5138,180487
4867,10,12,ITA,19,Sicilia,38.11569725,13.3623567,404,42,446,4236,4682,298,4571,339,9592,397546
4868,10,12,ITA,9,Toscana,43.76923077,11.25588885,205,40,245,6259,6504,466,10942,1180,18626,570706
4869,10,12,ITA,10,Umbria,43.10675841,12.38824698,61,9,70,1300,1370,148,2012,90,3472,138736
4870,10,12,ITA,2,Valle d'Aosta,45.73750286,7.320149366,9,3,12,213,225,32,1125,146,1496,21680
4871,10,12,ITA,5,Veneto,45.43490485,12.33845213,244,29,273,6016,6289,328,23323,2219,31831,808554
4872,10,13,ITA,13,Abruzzo,42.35122196,13.39843823,146,15,161,1518,1679,146,3153,488,5320,144769
4873,10,13,ITA,17,Basilicata,40.63947052,15.80514834,34,0,34,463,497,8,532,37,1066,82651
4874,10,13,ITA,18,Calabria,38.90597598,16.59440194,42,1,43,755,798,44,1486,104,2388,224137
4875,10,13,ITA,15,Campania,40.83956555,14.25084984,694,62,756,11022,11778,635,7564,485,19827,467964
4876,10,13,ITA,8,Emilia-Romagna,44.49436681,11.3417208,323,31,354,6522,6876,341,26982,4498,38356,728221
4877,10,13,ITA,6,Friuli Venezia Giulia,45.6494354,13.76813649,27,10,37,1367,1404,38,3850,356,5610,200782
4878,10,13,ITA,12,Lazio,41.89277044,12.48366722,896,83,979,9658,10637,579,9238,989,20864,861669
4879,10,13,ITA,7,Liguria,44.41149315,8.9326992,272,27,299,2624,2923,447,11357,1622,15902,188093
4880,10,13,ITA,3,Lombardia,45.46679409,9.190347404,546,62,608,13648,14256,1080,83550,16994,114800,1469625
4881,10,13,ITA,11,Marche,43.61675973,13.5188753,60,6,66,1329,1395,82,6325,992,8712,158948
4882,10,13,ITA,14,Molise,41.55774754,14.65916051,10,0,10,200,210,49,559,26,795,47568
4883,10,13,ITA,21,P.A. Bolzano,46.49933453,11.35662422,54,3,57,937,994,34,2856,293,4143,100855
4884,10,13,ITA,22,P.A. Trento,46.06893511,11.12123097,20,0,20,665,685,28,5417,411,6513,105581
4885,10,13,ITA,1,Piemonte,45.0732745,7.680687483,483,30,513,5452,5965,585,29394,4183,39542,480303
4886,10,13,ITA,16,Puglia,41.12559576,16.86736689,310,23,333,3665,3998,180,5235,616,9849,327324
4887,10,13,ITA,20,Sardegna,39.21531192,9.110616306,164,26,190,2710,2900,157,2227,168,5295,182625
4888,10,13,ITA,19,Sicilia,38.11569725,13.3623567,426,44,470,4407,4877,334,4708,341,9926,402751
4889,10,13,ITA,9,Toscana,43.76923077,11.25588885,218,44,262,6655,6917,480,11008,1181,19106,576101
4890,10,13,ITA,10,Umbria,43.10675841,12.38824698,68,11,79,1412,1491,136,2027,90,3608,140125
4891,10,13,ITA,2,Valle d'Aosta,45.73750286,7.320149366,11,3,14,244,258,33,1125,146,1529,21861
4892,10,13,ITA,5,Veneto,45.43490485,12.33845213,272,33,305,6350,6655,485,23435,2226,32316,810366
4893,10,14,ITA,13,Abruzzo,42.35122196,13.39843823,154,15,169,1632,1801,126,3156,489,5446,146193
4894,10,14,ITA,17,Basilicata,40.63947052,15.80514834,35,0,35,469,504,9,534,37,1075,83619
4895,10,14,ITA,18,Calabria,38.90597598,16.59440194,44,1,45,801,846,60,1498,104,2448,226572
4896,10,14,ITA,15,Campania,40.83956555,14.25084984,735,61,796,11647,12443,818,7715,487,20645,476051
4897,10,14,ITA,8,Emilia-Romagna,44.49436681,11.3417208,383,35,418,6730,7148,339,27045,4502,38695,736069
4898,10,14,ITA,6,Friuli Venezia Giulia,45.6494354,13.76813649,28,11,39,1515,1554,182,3882,356,5792,203239
4899,10,14,ITA,12,Lazio,41.89277044,12.48366722,937,85,1022,10041,11063,543,9350,994,21407,872710
4900,10,14,ITA,7,Liguria,44.41149315,8.9326992,286,29,315,2760,3075,362,11566,1623,16264,190129
4901,10,14,ITA,3,Lombardia,45.46679409,9.190347404,645,64,709,14509,15218,1844,84415,17011,116644,1488016
4902,10,14,ITA,11,Marche,43.61675973,13.5188753,64,8,72,1465,1537,166,6349,992,8878,160725
4903,10,14,ITA,14,Molise,41.55774754,14.65916051,9,0,9,215,224,18,563,26,813,47924
4904,10,14,ITA,21,P.A. Bolzano,46.49933453,11.35662422,54,3,57,1061,1118,124,2856,293,4267,101569
4905,10,14,ITA,22,P.A. Trento,46.06893511,11.12123097,20,0,20,638,658,29,5471,413,6542,106152
4906,10,14,ITA,1,Piemonte,45.0732745,7.680687483,562,33,595,5792,6387,499,29467,4187,40041,482280
4907,10,14,ITA,16,Puglia,41.12559576,16.86736689,311,23,334,3895,4229,315,5317,618,10164,330789
4908,10,14,ITA,20,Sardegna,39.21531192,9.110616306,172,26,198,2728,2926,122,2323,168,5417,184574
4909,10,14,ITA,19,Sicilia,38.11569725,13.3623567,447,49,496,4691,5187,366,4762,343,10292,407145
4910,10,14,ITA,9,Toscana,43.76923077,11.25588885,229,46,275,7152,7427,575,11071,1183,19681,583506
4911,10,14,ITA,10,Umbria,43.10675841,12.38824698,71,12,83,1540,1623,141,2035,91,3749,142109
4912,10,14,ITA,2,Valle d'Aosta,45.73750286,7.320149366,13,3,16,279,295,37,1125,146,1566,21997
4913,10,14,ITA,5,Veneto,45.43490485,12.33845213,271,35,306,6876,7182,657,23565,2226,32973,818552
4914,10,15,ITA,13,Abruzzo,42.35122196,13.39843823,159,10,169,1824,1993,203,3164,491,5648,148088
4915,10,15,ITA,17,Basilicata,40.63947052,15.80514834,36,0,36,503,539,37,536,37,1112,84605
4916,10,15,ITA,18,Calabria,38.90597598,16.59440194,51,3,54,805,859,39,1524,104,2487,228529
4917,10,15,ITA,15,Campania,40.83956555,14.25084984,762,66,828,12416,13244,1127,8032,496,21772,487147
4918,10,15,ITA,8,Emilia-Romagna,44.49436681,11.3417208,392,49,441,7080,7521,453,27124,4503,39148,742503
4919,10,15,ITA,6,Friuli Venezia Giulia,45.6494354,13.76813649,32,11,43,1604,1647,136,3923,358,5928,205301
4920,10,15,ITA,12,Lazio,41.89277044,12.48366722,969,90,1059,10546,11605,594,9395,1001,22001,884989
4921,10,15,ITA,7,Liguria,44.41149315,8.9326992,316,26,342,2771,3113,432,11957,1626,16696,192467
4922,10,15,ITA,3,Lombardia,45.46679409,9.190347404,726,72,798,16252,17050,2067,84624,17037,118711,1508334
4923,10,15,ITA,11,Marche,43.61675973,13.5188753,61,9,70,1594,1664,140,6362,992,9018,162176
4924,10,15,ITA,14,Molise,41.55774754,14.65916051,7,0,7,244,251,30,566,26,843,48828
4925,10,15,ITA,21,P.A. Bolzano,46.49933453,11.35662422,60,3,63,1130,1193,98,2879,293,4365,102467
4926,10,15,ITA,22,P.A. Trento,46.06893511,11.12123097,20,0,20,648,668,62,5521,415,6604,106544
4927,10,15,ITA,1,Piemonte,45.0732745,7.680687483,595,40,635,6673,7308,1033,29576,4190,41074,489887
4928,10,15,ITA,16,Puglia,41.12559576,16.86736689,319,26,345,4064,4409,257,5387,625,10421,334382
4929,10,15,ITA,20,Sardegna,39.21531192,9.110616306,180,28,208,2816,3024,186,2410,169,5603,186956
4930,10,15,ITA,19,Sicilia,38.11569725,13.3623567,468,52,520,4967,5487,399,4854,350,10691,411784
4931,10,15,ITA,9,Toscana,43.76923077,11.25588885,276,46,322,7584,7906,581,11171,1185,20262,591385
4932,10,15,ITA,10,Umbria,43.10675841,12.38824698,74,12,86,1731,1817,263,2104,91,4012,144075
4933,10,15,ITA,2,Valle d'Aosta,45.73750286,7.320149366,14,3,17,343,360,67,1127,146,1633,22227
4934,10,15,ITA,5,Veneto,45.43490485,12.33845213,279,40,319,7289,7608,600,23728,2237,33573,825788
4935,10,16,ITA,13,Abruzzo,42.35122196,13.39843823,167,11,178,1972,2150,178,3184,491,5825,150236
4936,10,16,ITA,17,Basilicata,40.63947052,15.80514834,36,0,36,547,583,57,548,38,1169,85721
4937,10,16,ITA,18,Calabria,38.90597598,16.59440194,51,4,55,849,904,102,1581,104,2589,231287
4938,10,16,ITA,15,Campania,40.83956555,14.25084984,786,67,853,13501,14354,1261,8180,499,23033,498492
4939,10,16,ITA,8,Emilia-Romagna,44.49436681,11.3417208,404,61,465,7568,8033,544,27155,4504,39692,748337
4940,10,16,ITA,6,Friuli Venezia Giulia,45.6494354,13.76813649,45,12,57,1742,1799,165,3935,359,6093,206998
4941,10,16,ITA,12,Lazio,41.89277044,12.48366722,1004,98,1102,11215,12317,795,9473,1006,22796,901184
4942,10,16,ITA,7,Liguria,44.41149315,8.9326992,347,32,379,2862,3241,585,12408,1632,17281,194933
4943,10,16,ITA,3,Lombardia,45.46679409,9.190347404,834,71,905,18223,19128,2419,84958,17044,121130,1527182
4944,10,16,ITA,11,Marche,43.61675973,13.5188753,73,10,83,1671,1754,115,6387,992,9133,163367
4945,10,16,ITA,14,Molise,41.55774754,14.65916051,8,0,8,257,265,21,573,26,864,49359
4946,10,16,ITA,21,P.A. Bolzano,46.49933453,11.35662422,66,6,72,1231,1303,128,2897,293,4493,103548
4947,10,16,ITA,22,P.A. Trento,46.06893511,11.12123097,20,0,20,705,725,111,5574,416,6715,107156
4948,10,16,ITA,1,Piemonte,45.0732745,7.680687483,658,43,701,7357,8058,821,29643,4194,41895,493847
4949,10,16,ITA,16,Puglia,41.12559576,16.86736689,326,26,352,4321,4673,313,5431,630,10734,338385
4950,10,16,ITA,20,Sardegna,39.21531192,9.110616306,187,29,216,2879,3095,133,2470,171,5736,189006
4951,10,16,ITA,19,Sicilia,38.11569725,13.3623567,471,58,529,5405,5934,578,4975,360,11269,416980
4952,10,16,ITA,9,Toscana,43.76923077,11.25588885,308,51,359,8156,8515,755,11315,1187,21017,598910
4953,10,16,ITA,10,Umbria,43.10675841,12.38824698,75,15,90,1871,1961,198,2158,91,4210,145535
4954,10,16,ITA,2,Valle d'Aosta,45.73750286,7.320149366,13,4,17,365,382,27,1132,146,1660,22334
4955,10,16,ITA,5,Veneto,45.43490485,12.33845213,299,40,339,7799,8138,704,23895,2244,34277,828067
4956,10,17,ITA,13,Abruzzo,42.35122196,13.39843823,169,13,182,2112,2294,148,3186,493,5973,151830
4957,10,17,ITA,17,Basilicata,40.63947052,15.80514834,40,0,40,598,638,57,550,38,1226,86834
4958,10,17,ITA,18,Calabria,38.90597598,16.59440194,58,5,63,931,994,94,1585,104,2683,234284
4959,10,17,ITA,15,Campania,40.83956555,14.25084984,817,75,892,14798,15690,1410,8254,499,24443,509918
4960,10,17,ITA,8,Emilia-Romagna,44.49436681,11.3417208,427,65,492,8157,8649,641,27175,4509,40333,754101
4961,10,17,ITA,6,Friuli Venezia Giulia,45.6494354,13.76813649,49,13,62,1877,1939,167,3962,359,6260,208471
4962,10,17,ITA,12,Lazio,41.89277044,12.48366722,1043,98,1141,12096,13237,994,9535,1018,23790,924313
4963,10,17,ITA,7,Liguria,44.41149315,8.9326992,364,38,402,3156,3558,464,12554,1633,17745,197088
4964,10,17,ITA,3,Lombardia,45.46679409,9.190347404,943,96,1039,20586,21625,2664,85112,17057,123794,1544959
4965,10,17,ITA,11,Marche,43.61675973,13.5188753,77,10,87,1775,1862,121,6400,992,9254,164588
4966,10,17,ITA,14,Molise,41.55774754,14.65916051,9,0,9,321,330,65,573,26,929,50306
4967,10,17,ITA,21,P.A. Bolzano,46.49933453,11.35662422,66,6,72,1372,1444,155,2911,293,4648,104499
4968,10,17,ITA,22,P.A. Trento,46.06893511,11.12123097,27,0,27,744,771,82,5609,417,6797,107750
4969,10,17,ITA,1,Piemonte,45.0732745,7.680687483,701,51,752,8128,8880,972,29791,4196,42867,498420
4970,10,17,ITA,16,Puglia,41.12559576,16.86736689,368,33,401,4579,4980,350,5472,632,11084,342024
4971,10,17,ITA,20,Sardegna,39.21531192,9.110616306,192,30,222,2966,3188,130,2506,172,5866,191734
4972,10,17,ITA,19,Sicilia,38.11569725,13.3623567,479,61,540,5741,6281,475,5101,362,11744,422068
4973,10,17,ITA,9,Toscana,43.76923077,11.25588885,344,50,394,8853,9247,879,11460,1189,21896,608130
4974,10,17,ITA,10,Umbria,43.10675841,12.38824698,99,16,115,2015,2130,205,2193,92,4415,147587
4975,10,17,ITA,2,Valle d'Aosta,45.73750286,7.320149366,17,2,19,439,458,78,1134,146,1738,22585
4976,10,17,ITA,5,Veneto,45.43490485,12.33845213,328,43,371,8369,8740,774,24064,2247,35051,832701
4977,10,18,ITA,13,Abruzzo,42.35122196,13.39843823,170,13,183,2330,2513,221,3187,494,6194,153850
4978,10,18,ITA,17,Basilicata,40.63947052,15.80514834,43,0,43,637,680,48,555,39,1274,87784
4979,10,18,ITA,18,Calabria,38.90597598,16.59440194,61,5,66,1006,1072,78,1585,104,2761,236641
4980,10,18,ITA,15,Campania,40.83956555,14.25084984,849,78,927,15938,16865,1376,8453,501,25819,519783
4981,10,18,ITA,8,Emilia-Romagna,44.49436681,11.3417208,439,67,506,8657,9163,526,27181,4515,40859,760075
4982,10,18,ITA,6,Friuli Venezia Giulia,45.6494354,13.76813649,56,14,70,2011,2081,155,3973,361,6415,209531
4983,10,18,ITA,12,Lazio,41.89277044,12.48366722,1085,99,1184,13196,14380,1198,9584,1024,24988,941774
4984,10,18,ITA,7,Liguria,44.41149315,8.9326992,402,39,441,3318,3759,370,12720,1636,18115,198617
4985,10,18,ITA,3,Lombardia,45.46679409,9.190347404,1065,110,1175,22119,23294,2975,86397,17078,126769,1565233
4986,10,18,ITA,11,Marche,43.61675973,13.5188753,88,13,101,1944,2045,204,6418,995,9458,166250
4987,10,18,ITA,14,Molise,41.55774754,14.65916051,12,0,12,343,355,27,575,26,956,51313
4988,10,18,ITA,21,P.A. Bolzano,46.49933453,11.35662422,67,7,74,1533,1607,171,2919,293,4819,105500
4989,10,18,ITA,22,P.A. Trento,46.06893511,11.12123097,38,0,38,763,801,48,5627,417,6845,108040
4990,10,18,ITA,1,Piemonte,45.0732745,7.680687483,780,55,835,8998,9833,1123,29959,4198,43990,505300
4991,10,18,ITA,16,Puglia,41.12559576,16.86736689,377,36,413,4820,5233,301,5517,635,11385,344122
4992,10,18,ITA,20,Sardegna,39.21531192,9.110616306,208,29,237,3159,3396,230,2526,174,6096,193627
4993,10,18,ITA,19,Sicilia,38.11569725,13.3623567,493,70,563,6227,6790,548,5137,365,12292,426503
4994,10,18,ITA,9,Toscana,43.76923077,11.25588885,385,55,440,9546,9986,906,11622,1194,22802,617111
4995,10,18,ITA,10,Umbria,43.10675841,12.38824698,115,14,129,2302,2431,327,2219,92,4742,149410
4996,10,18,ITA,2,Valle d'Aosta,45.73750286,7.320149366,20,2,22,506,528,73,1137,146,1811,22840
4997,10,18,ITA,5,Veneto,45.43490485,12.33845213,378,44,422,9003,9425,800,24170,2256,35851,836440
4998,10,19,ITA,13,Abruzzo,42.35122196,13.39843823,197,13,210,2459,2669,159,3190,494,6353,155193
4999,10,19,ITA,17,Basilicata,40.63947052,15.80514834,51,1,52,646,698,22,559,39,1296,88191
5000,10,19,ITA,18,Calabria,38.90597598,16.59440194,66,5,71,1099,1170,108,1595,104,2869,238117
5001,10,19,ITA,15,Campania,40.83956555,14.25084984,884,85,969,17345,18314,1593,8576,522,27412,529648
5002,10,19,ITA,8,Emilia-Romagna,44.49436681,11.3417208,481,70,551,9119,9670,552,27222,4518,41410,763923
5003,10,19,ITA,6,Friuli Venezia Giulia,45.6494354,13.76813649,62,13,75,2093,2168,90,3973,364,6505,210178
5004,10,19,ITA,12,Lazio,41.89277044,12.48366722,1130,111,1241,13950,15191,939,9703,1033,25927,954419
5005,10,19,ITA,7,Liguria,44.41149315,8.9326992,436,34,470,3441,3911,323,12886,1641,18438,199539
5006,10,19,ITA,3,Lombardia,45.46679409,9.190347404,1136,113,1249,23385,24634,1687,86738,17084,128456,1575120
5007,10,19,ITA,11,Marche,43.61675973,13.5188753,97,16,113,2005,2118,98,6443,995,9556,166944
5008,10,19,ITA,14,Molise,41.55774754,14.65916051,12,0,12,381,393,38,575,26,994,52049
5009,10,19,ITA,21,P.A. Bolzano,46.49933453,11.35662422,67,7,74,1616,1690,85,2920,294,4904,106284
5010,10,19,ITA,22,P.A. Trento,46.06893511,11.12123097,44,0,44,819,863,79,5643,418,6924,108329
5011,10,19,ITA,1,Piemonte,45.0732745,7.680687483,883,61,944,9663,10607,933,30113,4203,44923,511428
5012,10,19,ITA,16,Puglia,41.12559576,16.86736689,397,38,435,5028,5463,321,5604,639,11706,346220
5013,10,19,ITA,20,Sardegna,39.21531192,9.110616306,210,33,243,3259,3502,159,2579,174,6255,195681
5014,10,19,ITA,19,Sicilia,38.11569725,13.3623567,521,72,593,6426,7019,362,5267,368,12654,428508
5015,10,19,ITA,9,Toscana,43.76923077,11.25588885,449,62,511,10340,10851,986,11731,1206,23788,624289
5016,10,19,ITA,10,Umbria,43.10675841,12.38824698,131,15,146,2423,2569,167,2247,93,4909,150026
5017,10,19,ITA,2,Valle d'Aosta,45.73750286,7.320149366,26,4,30,628,658,135,1142,146,1946,23091
5018,10,19,ITA,5,Veneto,45.43490485,12.33845213,396,44,440,9405,9845,502,24253,2255,36353,838391
5019,10,20,ITA,13,Abruzzo,42.35122196,13.39843823,210,15,225,2620,2845,184,3194,495,6534,156991
5020,10,20,ITA,17,Basilicata,40.63947052,15.80514834,51,1,52,661,713,17,561,39,1313,89296
5021,10,20,ITA,18,Calabria,38.90597598,16.59440194,73,6,79,1173,1252,94,1607,104,2963,240594
5022,10,20,ITA,15,Campania,40.83956555,14.25084984,946,91,1037,18421,19458,1312,8732,534,28724,538297
5023,10,20,ITA,8,Emilia-Romagna,44.49436681,11.3417208,531,78,609,9559,10168,507,27226,4523,41917,769327
5024,10,20,ITA,6,Friuli Venezia Giulia,45.6494354,13.76813649,65,14,79,1853,1932,131,4338,366,6636,211397
5025,10,20,ITA,12,Lazio,41.89277044,12.48366722,1196,123,1319,15014,16333,1224,9780,1038,27151,969373
5026,10,20,ITA,7,Liguria,44.41149315,8.9326992,505,32,537,3947,4484,907,13214,1647,19345,202738
5027,10,20,ITA,3,Lombardia,45.46679409,9.190347404,1268,123,1391,24913,26304,2023,87072,17103,130479,1588800
5028,10,20,ITA,11,Marche,43.61675973,13.5188753,99,19,118,2064,2182,89,6467,996,9645,167857
5029,10,20,ITA,14,Molise,41.55774754,14.65916051,12,0,12,401,413,26,581,26,1020,52527
5030,10,20,ITA,21,P.A. Bolzano,46.49933453,11.35662422,96,7,103,1791,1894,209,2924,295,5113,107299
5031,10,20,ITA,22,P.A. Trento,46.06893511,11.12123097,45,1,46,718,764,94,5836,418,7018,108619
5032,10,20,ITA,1,Piemonte,45.0732745,7.680687483,1037,62,1099,10783,11882,1396,30228,4209,46319,519289
5033,10,20,ITA,16,Puglia,41.12559576,16.86736689,432,39,471,5259,5730,295,5629,642,12001,350691
5034,10,20,ITA,20,Sardegna,39.21531192,9.110616306,226,34,260,3426,3686,221,2613,177,6476,197486
5035,10,20,ITA,19,Sicilia,38.11569725,13.3623567,542,77,619,6878,7497,574,5353,378,13228,434040
5036,10,20,ITA,9,Toscana,43.76923077,11.25588885,475,72,547,10999,11546,812,11846,1208,24600,631648
5037,10,20,ITA,10,Umbria,43.10675841,12.38824698,150,20,170,2505,2675,194,2335,93,5103,152168
5038,10,20,ITA,2,Valle d'Aosta,45.73750286,7.320149366,36,5,41,684,725,75,1150,146,2021,23263
5039,10,20,ITA,5,Veneto,45.43490485,12.33845213,459,51,510,9746,10256,490,24319,2268,36843,841548
5040,10,21,ITA,13,Abruzzo,42.35122196,13.39843823,212,14,226,2865,3091,252,3195,500,6786,158874
5041,10,21,ITA,17,Basilicata,40.63947052,15.80514834,48,4,52,723,775,85,584,39,1398,90497
5042,10,21,ITA,18,Calabria,38.90597598,16.59440194,81,6,87,1293,1380,136,1614,105,3099,243043
5043,10,21,ITA,15,Campania,40.83956555,14.25084984,996,85,1081,20020,21101,1760,8838,545,30484,548083
5044,10,21,ITA,8,Emilia-Romagna,44.49436681,11.3417208,596,86,682,10118,10800,671,27257,4531,42588,777142
5045,10,21,ITA,6,Friuli Venezia Giulia,45.6494354,13.76813649,76,16,92,2014,2106,219,4382,367,6855,212729
5046,10,21,ITA,12,Lazio,41.89277044,12.48366722,1226,129,1355,16048,17403,1219,9913,1054,28370,984926
5047,10,21,ITA,7,Liguria,44.41149315,8.9326992,547,31,578,4043,4621,546,13614,1656,19891,204834
5048,10,21,ITA,3,Lombardia,45.46679409,9.190347404,1521,134,1655,28235,29890,4125,87591,17123,134604,1611623
5049,10,21,ITA,11,Marche,43.61675973,13.5188753,115,19,134,2243,2377,226,6497,997,9871,169343
5050,10,21,ITA,14,Molise,41.55774754,14.65916051,9,1,10,415,425,22,591,26,1042,53291
5051,10,21,ITA,21,P.A. Bolzano,46.49933453,11.35662422,96,7,103,1977,2080,189,2926,296,5302,108212
5052,10,21,ITA,22,P.A. Trento,46.06893511,11.12123097,48,2,50,798,848,148,5898,420,7166,109666
5053,10,21,ITA,1,Piemonte,45.0732745,7.680687483,1111,74,1185,12250,13435,1799,30467,4216,48118,529281
5054,10,21,ITA,16,Puglia,41.12559576,16.86736689,438,42,480,5511,5991,324,5690,644,12325,355311
5055,10,21,ITA,20,Sardegna,39.21531192,9.110616306,236,36,272,3539,3811,167,2652,180,6643,199392
5056,10,21,ITA,19,Sicilia,38.11569725,13.3623567,565,83,648,7202,7850,562,5551,389,13790,437540
5057,10,21,ITA,9,Toscana,43.76923077,11.25588885,503,76,579,11660,12239,866,12006,1221,25466,639007
5058,10,21,ITA,10,Umbria,43.10675841,12.38824698,152,20,172,2783,2955,350,2403,95,5453,154074
5059,10,21,ITA,2,Valle d'Aosta,45.73750286,7.320149366,42,5,47,784,831,111,1155,146,2132,23483
5060,10,21,ITA,5,Veneto,45.43490485,12.33845213,439,56,495,10938,11433,1422,24550,2282,38265,849385
5061,10,22,ITA,13,Abruzzo,42.35122196,13.39843823,208,16,224,3152,3376,306,3214,501,7091,160689
5062,10,22,ITA,17,Basilicata,40.63947052,15.80514834,48,4,52,776,828,83,611,42,1481,91753
5063,10,22,ITA,18,Calabria,38.90597598,16.59440194,86,8,94,1443,1537,187,1644,105,3286,246034
5064,10,22,ITA,15,Campania,40.83956555,14.25084984,1037,94,1131,21430,22561,1541,8913,551,32025,558506
5065,10,22,ITA,8,Emilia-Romagna,44.49436681,11.3417208,636,86,722,10941,11663,889,27277,4537,43477,783681
5066,10,22,ITA,6,Friuli Venezia Giulia,45.6494354,13.76813649,83,14,97,2128,2225,220,4482,368,7075,214444
5067,10,22,ITA,12,Lazio,41.89277044,12.48366722,1293,131,1424,17107,18531,1251,10020,1070,29621,1002866
5068,10,22,ITA,7,Liguria,44.41149315,8.9326992,540,34,574,4492,5066,690,13842,1673,20581,207034
5069,10,22,ITA,3,Lombardia,45.46679409,9.190347404,1685,156,1841,31677,33518,4125,88059,17152,138729,1633109
5070,10,22,ITA,11,Marche,43.61675973,13.5188753,133,19,152,2472,2624,321,6570,998,10192,171050
5071,10,22,ITA,14,Molise,41.55774754,14.65916051,13,1,14,436,450,28,594,26,1070,53975
5072,10,22,ITA,21,P.A. Bolzano,46.49933453,11.35662422,106,8,114,2204,2318,247,2935,296,5549,109343
5073,10,22,ITA,22,P.A. Trento,46.06893511,11.12123097,57,1,58,911,969,153,5927,423,7319,109669
5074,10,22,ITA,1,Piemonte,45.0732745,7.680687483,1226,79,1305,13475,14780,1550,30661,4227,49668,537462
5075,10,22,ITA,16,Puglia,41.12559576,16.86736689,448,50,498,5781,6279,485,5886,645,12810,359262
5076,10,22,ITA,20,Sardegna,39.21531192,9.110616306,264,36,300,3693,3993,243,2712,181,6886,202306
5077,10,22,ITA,19,Sicilia,38.11569725,13.3623567,588,89,677,7863,8540,796,5649,397,14586,442472
5078,10,22,ITA,9,Toscana,43.76923077,11.25588885,524,82,606,12655,13261,1145,12121,1229,26611,646277
5079,10,22,ITA,10,Umbria,43.10675841,12.38824698,171,22,193,3077,3270,407,2493,97,5860,156285
5080,10,22,ITA,2,Valle d'Aosta,45.73750286,7.320149366,48,3,51,854,905,87,1165,149,2219,23688
5081,10,22,ITA,5,Veneto,45.43490485,12.33845213,500,59,559,12049,12608,1325,24681,2301,39590,854703
5082,10,23,ITA,13,Abruzzo,42.35122196,13.39843823,228,16,244,3285,3529,234,3293,503,7325,162471
5083,10,23,ITA,17,Basilicata,40.63947052,15.80514834,54,4,58,849,907,89,621,42,1570,93187
5084,10,23,ITA,18,Calabria,38.90597598,16.59440194,100,9,109,1586,1695,159,1645,105,3445,249135
5085,10,23,ITA,15,Campania,40.83956555,14.25084984,1090,98,1188,23447,24635,2280,9107,563,34305,571147
5086,10,23,ITA,8,Emilia-Romagna,44.49436681,11.3417208,657,86,743,11771,12514,888,27304,4547,44365,790989
5087,10,23,ITA,6,Friuli Venezia Giulia,45.6494354,13.76813649,88,19,107,2370,2477,340,4569,369,7415,216003
5088,10,23,ITA,12,Lazio,41.89277044,12.48366722,1354,135,1489,18332,19821,1389,10108,1081,31010,1021323
5089,10,23,ITA,7,Liguria,44.41149315,8.9326992,598,33,631,4838,5469,778,14210,1680,21359,209220
5090,10,23,ITA,3,Lombardia,45.46679409,9.190347404,2013,184,2197,35753,37950,4916,88536,17159,143645,1655276
5091,10,23,ITA,11,Marche,43.61675973,13.5188753,152,22,174,2875,3049,453,6596,1000,10645,173274
5092,10,23,ITA,14,Molise,41.55774754,14.65916051,13,1,14,480,494,56,606,26,1126,54552
5093,10,23,ITA,21,P.A. Bolzano,46.49933453,11.35662422,106,8,114,2468,2582,269,2940,296,5818,110930
5094,10,23,ITA,22,P.A. Trento,46.06893511,11.12123097,65,3,68,1061,1129,207,5974,423,7526,110387
5095,10,23,ITA,1,Piemonte,45.0732745,7.680687483,1362,84,1446,15016,16462,2032,31002,4236,51700,547164
5096,10,23,ITA,16,Puglia,41.12559576,16.86736689,479,52,531,6297,6828,590,5926,646,13400,364270
5097,10,23,ITA,20,Sardegna,39.21531192,9.110616306,275,36,311,3975,4286,349,2768,181,7235,205575
5098,10,23,ITA,19,Sicilia,38.11569725,13.3623567,593,89,682,8454,9136,730,5772,408,15316,447704
5099,10,23,ITA,9,Toscana,43.76923077,11.25588885,574,82,656,13718,14374,1290,12290,1237,27901,653719
5100,10,23,ITA,10,Umbria,43.10675841,12.38824698,183,21,204,3426,3630,447,2577,100,6307,158186
5101,10,23,ITA,2,Valle d'Aosta,45.73750286,7.320149366,50,3,53,948,1001,97,1166,149,2316,23862
5102,10,23,ITA,5,Veneto,45.43490485,12.33845213,515,64,579,13455,14034,1550,24798,2308,41140,860733
5103,10,24,ITA,13,Abruzzo,42.35122196,13.39843823,228,18,246,3496,3742,375,3455,503,7700,164810
5104,10,24,ITA,17,Basilicata,40.63947052,15.80514834,53,5,58,887,945,50,630,44,1619,94401
5105,10,24,ITA,18,Calabria,38.90597598,16.59440194,100,10,110,1739,1849,166,1657,105,3611,252469
5106,10,24,ITA,15,Campania,40.83956555,14.25084984,1118,108,1226,25077,26303,1718,9149,571,36023,579568
5107,10,24,ITA,8,Emilia-Romagna,44.49436681,11.3417208,723,89,812,12830,13642,1180,27343,4557,45542,799074
5108,10,24,ITA,6,Friuli Venezia Giulia,45.6494354,13.76813649,100,16,116,2660,2776,412,4679,372,7827,218014
5109,10,24,ITA,12,Lazio,41.89277044,12.48366722,1438,141,1579,19826,21405,1687,10202,1090,32697,1041123
5110,10,24,ITA,7,Liguria,44.41149315,8.9326992,641,38,679,5081,5760,1035,14948,1686,22394,212171
5111,10,24,ITA,3,Lombardia,45.46679409,9.190347404,2153,213,2366,40319,42685,4956,88706,17210,148601,1675053
5112,10,24,ITA,11,Marche,43.61675973,13.5188753,178,23,201,3098,3299,274,6619,1001,10919,174895
5113,10,24,ITA,14,Molise,41.55774754,14.65916051,16,2,18,507,525,66,640,27,1192,55250
5114,10,24,ITA,21,P.A. Bolzano,46.49933453,11.35662422,133,12,145,2711,2856,277,2943,296,6095,112056
5115,10,24,ITA,22,P.A. Trento,46.06893511,11.12123097,59,4,63,1193,1256,162,6008,424,7688,110914
5116,10,24,ITA,1,Piemonte,45.0732745,7.680687483,1483,88,1571,16272,17843,1548,31157,4248,53248,556121
5117,10,24,ITA,16,Puglia,41.12559576,16.86736689,522,53,575,6823,7398,631,5977,656,14031,367410
5118,10,24,ITA,20,Sardegna,39.21531192,9.110616306,287,36,323,4263,4586,329,2794,184,7564,208859
5119,10,24,ITA,19,Sicilia,38.11569725,13.3623567,606,90,696,9193,9889,886,5896,417,16202,452738
5120,10,24,ITA,9,Toscana,43.76923077,11.25588885,640,87,727,14961,15688,1526,12491,1248,29427,662605
5121,10,24,ITA,10,Umbria,43.10675841,12.38824698,203,25,228,3793,4021,525,2709,102,6832,160255
5122,10,24,ITA,2,Valle d'Aosta,45.73750286,7.320149366,58,2,60,1033,1093,112,1183,152,2428,24087
5123,10,24,ITA,5,Veneto,45.43490485,12.33845213,548,68,616,15005,15621,1729,24931,2317,42869,866907
5124,10,25,ITA,13,Abruzzo,42.35122196,13.39843823,245,18,263,3822,4085,368,3469,514,8068,166730
5125,10,25,ITA,17,Basilicata,40.63947052,15.80514834,53,5,58,955,1013,77,639,44,1696,95573
5126,10,25,ITA,18,Calabria,38.90597598,16.59440194,106,10,116,1897,2013,179,1671,106,3790,255683
5127,10,25,ITA,15,Campania,40.83956555,14.25084984,1151,113,1264,27456,28720,2590,9322,571,38613,587003
5128,10,25,ITA,8,Emilia-Romagna,44.49436681,11.3417208,757,88,845,13983,14828,1192,27345,4561,46734,804679
5129,10,25,ITA,6,Friuli Venezia Giulia,45.6494354,13.76813649,112,23,135,2892,3027,334,4760,374,8161,219485
5130,10,25,ITA,12,Lazio,41.89277044,12.48366722,1476,146,1622,21193,22815,1541,10323,1100,34238,1057293
5131,10,25,ITA,7,Liguria,44.41149315,8.9326992,696,41,737,5299,6036,657,15324,1691,23051,214109
5132,10,25,ITA,3,Lombardia,45.46679409,9.190347404,2326,231,2557,45426,47983,5762,89145,17235,154363,1698094
5133,10,25,ITA,11,Marche,43.61675973,13.5188753,178,23,201,3525,3726,521,6711,1003,11440,177287
5134,10,25,ITA,14,Molise,41.55774754,14.65916051,20,2,22,528,550,26,640,28,1218,55751
5135,10,25,ITA,21,P.A. Bolzano,46.49933453,11.35662422,147,11,158,3029,3187,339,2951,296,6434,113387
5136,10,25,ITA,22,P.A. Trento,46.06893511,11.12123097,72,4,76,1256,1332,104,6035,425,7792,111246
5137,10,25,ITA,1,Piemonte,45.0732745,7.680687483,1601,94,1695,18182,19877,2287,31399,4259,55535,566796
5138,10,25,ITA,16,Puglia,41.12559576,16.86736689,548,57,605,7267,7872,515,6011,663,14546,370561
5139,10,25,ITA,20,Sardegna,39.21531192,9.110616306,299,34,333,4421,4754,195,2814,191,7759,211113
5140,10,25,ITA,19,Sicilia,38.11569725,13.3623567,642,95,737,9818,10555,695,5914,428,16897,456572
5141,10,25,ITA,9,Toscana,43.76923077,11.25588885,714,111,825,16495,17320,1863,12708,1262,31290,671386
5142,10,25,ITA,10,Umbria,43.10675841,12.38824698,215,29,244,4151,4395,463,2795,105,7295,162084
5143,10,25,ITA,2,Valle d'Aosta,45.73750286,7.320149366,63,2,65,1116,1181,97,1191,153,2525,24256
5144,10,25,ITA,5,Veneto,45.43490485,12.33845213,585,71,656,16316,16972,1468,25036,2329,44337,871568
5145,10,26,ITA,13,Abruzzo,42.35122196,13.39843823,249,21,270,4083,4353,348,3537,524,8414,168842
5146,10,26,ITA,17,Basilicata,40.63947052,15.80514834,66,6,72,937,1009,8,651,44,1704,95707
5147,10,26,ITA,18,Calabria,38.90597598,16.59440194,108,9,117,2067,2184,180,1678,108,3970,258151
5148,10,26,ITA,15,Campania,40.83956555,14.25084984,1191,123,1314,29361,30675,1981,9332,587,40594,594439
5149,10,26,ITA,8,Emilia-Romagna,44.49436681,11.3417208,816,93,909,14860,15769,1146,27544,4564,47877,811249
5150,10,26,ITA,6,Friuli Venezia Giulia,45.6494354,13.76813649,119,27,146,3139,3285,334,4833,377,8495,220578
5151,10,26,ITA,12,Lazio,41.89277044,12.48366722,1599,158,1757,22649,24406,1698,10414,1116,35936,1071581
5152,10,26,ITA,7,Liguria,44.41149315,8.9326992,788,46,834,5608,6442,419,15324,1704,23470,215143
5153,10,26,ITA,3,Lombardia,45.46679409,9.190347404,2459,242,2701,47624,50325,3570,90356,17252,157933,1711397
5154,10,26,ITA,11,Marche,43.61675973,13.5188753,227,26,253,3669,3922,238,6752,1004,11678,178313
5155,10,26,ITA,14,Molise,41.55774754,14.65916051,19,3,22,618,640,101,651,28,1319,56300
5156,10,26,ITA,21,P.A. Bolzano,46.49933453,11.35662422,152,12,164,3337,3501,321,2955,299,6755,114559
5157,10,26,ITA,22,P.A. Trento,46.06893511,11.12123097,81,5,86,1354,1440,113,6039,426,7905,111484
5158,10,26,ITA,1,Piemonte,45.0732745,7.680687483,1849,102,1951,19316,21267,1625,31620,4273,57160,574505
5159,10,26,ITA,16,Puglia,41.12559576,16.86736689,589,59,648,7631,8279,424,6018,673,14970,372347
5160,10,26,ITA,20,Sardegna,39.21531192,9.110616306,303,35,338,4582,4920,231,2878,192,7990,213063
5161,10,26,ITA,19,Sicilia,38.11569725,13.3623567,677,98,775,10170,10945,568,6081,439,17465,459725
5162,10,26,ITA,9,Toscana,43.76923077,11.25588885,779,110,889,18487,19376,2171,12810,1275,33461,680058
5163,10,26,ITA,10,Umbria,43.10675841,12.38824698,239,31,270,4313,4583,263,2867,108,7558,162797
5164,10,26,ITA,2,Valle d'Aosta,45.73750286,7.320149366,75,2,77,1239,1316,144,1199,154,2669,24533
5165,10,26,ITA,5,Veneto,45.43490485,12.33845213,612,76,688,17359,18047,1129,25087,2332,45466,874701
5166,10,27,ITA,13,Abruzzo,42.35122196,13.39843823,284,22,306,4303,4609,345,3618,532,8759,170530
5167,10,27,ITA,17,Basilicata,40.63947052,15.80514834,68,7,75,1001,1076,77,661,44,1781,96865
5168,10,27,ITA,18,Calabria,38.90597598,16.59440194,117,9,126,2199,2325,234,1768,111,4204,260697
5169,10,27,ITA,15,Campania,40.83956555,14.25084984,1210,140,1350,31491,32841,2761,9907,607,43355,602980
5170,10,27,ITA,8,Emilia-Romagna,44.49436681,11.3417208,934,103,1037,16043,17080,1413,27626,4579,49285,818615
5171,10,27,ITA,6,Friuli Venezia Giulia,45.6494354,13.76813649,139,31,170,3275,3445,241,4913,378,8736,222085
5172,10,27,ITA,12,Lazio,41.89277044,12.48366722,1632,166,1798,24344,26142,1993,10648,1139,37929,1091869
5173,10,27,ITA,7,Liguria,44.41149315,8.9326992,837,45,882,6075,6957,1127,15922,1718,24597,218449
5174,10,27,ITA,3,Lombardia,45.46679409,9.190347404,2715,271,2986,51898,54884,5035,90774,17310,162968,1729725
5175,10,27,ITA,11,Marche,43.61675973,13.5188753,250,28,278,3947,4225,380,6827,1006,12058,179841
5176,10,27,ITA,14,Molise,41.55774754,14.65916051,17,4,21,671,692,66,664,29,1385,56971
5177,10,27,ITA,21,P.A. Bolzano,46.49933453,11.35662422,169,12,181,3557,3738,242,2959,300,6997,115563
5178,10,27,ITA,22,P.A. Trento,46.06893511,11.12123097,84,5,89,1559,1648,257,6087,427,8162,111986
5179,10,27,ITA,1,Piemonte,45.0732745,7.680687483,2016,121,2137,21103,23240,2458,32092,4286,59618,585298
5180,10,27,ITA,16,Puglia,41.12559576,16.86736689,635,62,697,8011,8708,611,6187,686,15581,377074
5181,10,27,ITA,20,Sardegna,39.21531192,9.110616306,306,36,342,4719,5061,174,2904,199,8164,215251
5182,10,27,ITA,19,Sicilia,38.11569725,13.3623567,727,103,830,10904,11734,860,6142,449,18325,464116
5183,10,27,ITA,9,Toscana,43.76923077,11.25588885,804,119,923,20117,21040,1823,12954,1290,35284,688497
5184,10,27,ITA,10,Umbria,43.10675841,12.38824698,248,37,285,4476,4761,314,3001,110,7872,164539
5185,10,27,ITA,2,Valle d'Aosta,45.73750286,7.320149366,99,7,106,1261,1367,57,1203,156,2726,24643
5186,10,27,ITA,5,Veneto,45.43490485,12.33845213,664,83,747,18770,19517,1526,25131,2344,46992,880224
5187,10,28,ITA,13,Abruzzo,42.35122196,13.39843823,306,26,332,4697,5029,434,3630,534,9193,172659
5188,10,28,ITA,17,Basilicata,40.63947052,15.80514834,73,7,80,1104,1184,120,670,47,1901,98626
5189,10,28,ITA,18,Calabria,38.90597598,16.59440194,120,11,131,2373,2504,196,1785,111,4400,263352
5190,10,28,ITA,15,Campania,40.83956555,14.25084984,1235,160,1395,33491,34886,2427,10272,624,45782,611945
5191,10,28,ITA,8,Emilia-Romagna,44.49436681,11.3417208,999,119,1118,17112,18230,1212,27671,4593,50494,827354
5192,10,28,ITA,6,Friuli Venezia Giulia,45.6494354,13.76813649,146,35,181,3551,3732,406,5028,382,9142,223790
5193,10,28,ITA,12,Lazio,41.89277044,12.48366722,1669,166,1835,26111,27946,1963,10788,1158,39892,1111817
5194,10,28,ITA,7,Liguria,44.41149315,8.9326992,878,46,924,6554,7478,926,16312,1733,25523,221286
5195,10,28,ITA,3,Lombardia,45.46679409,9.190347404,3072,292,3364,58042,61406,7558,91763,17357,170526,1755084
5196,10,28,ITA,11,Marche,43.61675973,13.5188753,250,32,282,4244,4526,351,6875,1008,12409,181572
5197,10,28,ITA,14,Molise,41.55774754,14.65916051,19,4,23,676,699,19,674,31,1404,57441
5198,10,28,ITA,21,P.A. Bolzano,46.49933453,11.35662422,181,15,196,3725,3921,190,2962,304,7187,116456
5199,10,28,ITA,22,P.A. Trento,46.06893511,11.12123097,94,6,100,1667,1767,191,6154,432,8353,112387
5200,10,28,ITA,1,Piemonte,45.0732745,7.680687483,2237,135,2372,23415,25787,2827,32353,4305,62445,599224
5201,10,28,ITA,16,Puglia,41.12559576,16.86736689,690,70,760,8677,9437,772,6217,699,16353,383008
5202,10,28,ITA,20,Sardegna,39.21531192,9.110616306,298,37,335,5013,5348,362,2973,205,8526,218343
5203,10,28,ITA,19,Sicilia,38.11569725,13.3623567,787,111,898,11290,12188,708,6386,459,19033,468458
5204,10,28,ITA,9,Toscana,43.76923077,11.25588885,857,130,987,21373,22360,1708,13335,1297,36992,696653
5205,10,28,ITA,10,Umbria,43.10675841,12.38824698,255,37,292,4707,4999,401,3160,114,8273,167083
5206,10,28,ITA,2,Valle d'Aosta,45.73750286,7.320149366,107,7,114,1316,1430,77,1216,157,2803,24935
5207,10,28,ITA,5,Veneto,45.43490485,12.33845213,708,90,798,20802,21600,2143,25180,2355,49135,886165
5208,10,29,ITA,13,Abruzzo,42.35122196,13.39843823,331,26,357,5087,5444,482,3690,540,9674,174707
5209,10,29,ITA,17,Basilicata,40.63947052,15.80514834,74,7,81,1175,1256,86,684,47,1987,99620
5210,10,29,ITA,18,Calabria,38.90597598,16.59440194,134,7,141,2573,2714,225,1798,113,4625,266077
5211,10,29,ITA,15,Campania,40.83956555,14.25084984,1297,164,1461,36243,37704,3103,10537,644,48885,622408
5212,10,29,ITA,8,Emilia-Romagna,44.49436681,11.3417208,1054,123,1177,18536,19713,1545,27724,4601,52038,835830
5213,10,29,ITA,6,Friuli Venezia Giulia,45.6494354,13.76813649,152,34,186,3922,4108,468,5115,387,9610,225536
5214,10,29,ITA,12,Lazio,41.89277044,12.48366722,1786,168,1954,27758,29712,1995,11002,1173,41887,1132105
5215,10,29,ITA,7,Liguria,44.41149315,8.9326992,907,50,957,6979,7936,1018,16863,1742,26541,224168
5216,10,29,ITA,3,Lombardia,45.46679409,9.190347404,3355,345,3700,64184,67884,7339,92567,17414,177865,1780305
5217,10,29,ITA,11,Marche,43.61675973,13.5188753,247,39,286,4850,5136,686,6950,1009,13095,183944
5218,10,29,ITA,14,Molise,41.55774754,14.65916051,19,4,23,768,791,94,675,32,1498,58031
5219,10,29,ITA,21,P.A. Bolzano,46.49933453,11.35662422,193,15,208,4009,4217,298,2962,306,7485,117659
5220,10,29,ITA,22,P.A. Trento,46.06893511,11.12123097,109,9,118,1503,1621,173,6470,435,8526,112836
5221,10,29,ITA,1,Piemonte,45.0732745,7.680687483,2381,146,2527,25364,27891,2585,32807,4332,65030,609925
5222,10,29,ITA,16,Puglia,41.12559576,16.86736689,669,78,747,9255,10002,716,6361,706,17069,386874
5223,10,29,ITA,20,Sardegna,39.21531192,9.110616306,322,39,361,5205,5566,282,3035,207,8808,221404
5224,10,29,ITA,19,Sicilia,38.11569725,13.3623567,839,115,954,11791,12745,789,6605,472,19822,472930
5225,10,29,ITA,9,Toscana,43.76923077,11.25588885,956,137,1093,22877,23970,1966,13678,1310,38958,706557
5226,10,29,ITA,10,Umbria,43.10675841,12.38824698,260,41,301,5270,5571,694,3277,119,8967,169837
5227,10,29,ITA,2,Valle d'Aosta,45.73750286,7.320149366,120,7,127,1457,1584,178,1235,162,2981,25235
5228,10,29,ITA,5,Veneto,45.43490485,12.33845213,759,97,856,22770,23626,2109,25247,2371,51244,890507
5229,10,30,ITA,13,Abruzzo,42.35122196,13.39843823,355,27,382,5414,5796,428,3764,542,10102,176636
5230,10,30,ITA,17,Basilicata,40.63947052,15.80514834,74,7,81,1254,1335,95,699,48,2082,101446
5231,10,30,ITA,18,Calabria,38.90597598,16.59440194,142,9,151,2799,2950,239,1799,114,4863,268922
5232,10,30,ITA,15,Campania,40.83956555,14.25084984,1385,161,1546,38804,40350,3186,11062,659,52071,634861
5233,10,30,ITA,8,Emilia-Romagna,44.49436681,11.3417208,1157,119,1276,20145,21421,1763,27764,4612,53797,842483
5234,10,30,ITA,6,Friuli Venezia Giulia,45.6494354,13.76813649,161,35,196,4339,4535,505,5186,394,10115,227470
5235,10,30,ITA,12,Lazio,41.89277044,12.48366722,1873,175,2048,29699,31747,2246,11196,1190,44133,1152217
5236,10,30,ITA,7,Liguria,44.41149315,8.9326992,948,52,1000,7322,8322,999,17469,1749,27540,226812
5237,10,30,ITA,3,Lombardia,45.46679409,9.190347404,3698,370,4068,71161,75229,8960,94134,17462,186825,1807884
5238,10,30,ITA,11,Marche,43.61675973,13.5188753,262,39,301,5340,5641,524,6965,1013,13619,185912
5239,10,30,ITA,14,Molise,41.55774754,14.65916051,18,6,24,864,888,114,692,32,1612,58819
5240,10,30,ITA,21,P.A. Bolzano,46.49933453,11.35662422,233,18,251,4310,4561,350,2966,308,7835,118867
5241,10,30,ITA,22,P.A. Trento,46.06893511,11.12123097,118,9,127,1562,1689,222,6622,437,8748,113372
5242,10,30,ITA,1,Piemonte,45.0732745,7.680687483,2547,159,2706,27682,30388,2719,33006,4355,67749,623529
5243,10,30,ITA,16,Puglia,41.12559576,16.86736689,634,84,718,9981,10699,791,6448,713,17860,391765
5244,10,30,ITA,20,Sardegna,39.21531192,9.110616306,323,40,363,5458,5821,298,3071,214,9106,224602
5245,10,30,ITA,19,Sicilia,38.11569725,13.3623567,895,117,1012,12552,13564,984,6758,484,20806,477579
5246,10,30,ITA,9,Toscana,43.76923077,11.25588885,1007,153,1160,25260,26420,2765,13983,1320,41723,717521
5247,10,30,ITA,10,Umbria,43.10675841,12.38824698,260,42,302,5864,6166,729,3409,121,9696,171539
5248,10,30,ITA,2,Valle d'Aosta,45.73750286,7.320149366,127,7,134,1583,1717,155,1253,166,3136,25710
5249,10,30,ITA,5,Veneto,45.43490485,12.33845213,777,117,894,25653,26547,3012,25321,2388,54256,898237
5250,10,31,ITA,13,Abruzzo,42.35122196,13.39843823,371,29,400,5803,6203,450,3799,550,10552,178791
5251,10,31,ITA,17,Basilicata,40.63947052,15.80514834,83,7,90,1356,1446,117,704,49,2199,103139
5252,10,31,ITA,18,Calabria,38.90597598,16.59440194,154,9,163,2961,3124,202,1825,116,5065,271920
5253,10,31,ITA,15,Campania,40.83956555,14.25084984,1403,168,1571,42159,43730,3669,11337,673,55740,651607
5254,10,31,ITA,8,Emilia-Romagna,44.49436681,11.3417208,1223,125,1348,21865,23213,2046,27997,4631,55841,849335
5255,10,31,ITA,6,Friuli Venezia Giulia,45.6494354,13.76813649,167,36,203,4929,5132,726,5312,397,10841,229633
5256,10,31,ITA,12,Lazio,41.89277044,12.48366722,1944,182,2126,31780,33906,2289,11304,1212,46422,1174268
5257,10,31,ITA,7,Liguria,44.41149315,8.9326992,1036,57,1093,7338,8431,1068,18403,1774,28608,229381
5258,10,31,ITA,3,Lombardia,45.46679409,9.190347404,4033,392,4425,77586,82011,8919,96198,17535,195744,1834360
5259,10,31,ITA,11,Marche,43.61675973,13.5188753,275,47,322,5783,6105,502,6997,1019,14121,187640
5260,10,31,ITA,14,Molise,41.55774754,14.65916051,17,6,23,933,956,83,702,37,1695,59452
5261,10,31,ITA,21,P.A. Bolzano,46.49933453,11.35662422,237,18,255,4845,5100,547,2970,312,8382,120339
5262,10,31,ITA,22,P.A. Trento,46.06893511,11.12123097,121,9,130,1795,1925,390,6775,438,9138,114145
5263,10,31,ITA,1,Piemonte,45.0732745,7.680687483,2683,174,2857,29967,32824,2887,33429,4383,70636,636308
5264,10,31,ITA,16,Puglia,41.12559576,16.86736689,638,87,725,10668,11393,762,6506,723,18622,396687
5265,10,31,ITA,20,Sardegna,39.21531192,9.110616306,349,39,388,5667,6055,325,3149,227,9431,227323
5266,10,31,ITA,19,Sicilia,38.11569725,13.3623567,962,122,1084,13358,14442,952,6814,502,21758,482882
5267,10,31,ITA,9,Toscana,43.76923077,11.25588885,1046,163,1209,26635,27844,2540,15074,1345,44263,727110
5268,10,31,ITA,10,Umbria,43.10675841,12.38824698,277,43,320,6234,6554,483,3499,126,10179,173851
5269,10,31,ITA,2,Valle d'Aosta,45.73750286,7.320149366,146,7,153,1660,1813,104,1259,168,3240,25954
5270,10,31,ITA,5,Veneto,45.43490485,12.33845213,801,123,924,28255,29179,2697,25373,2401,56953,904337
5271,11,1,ITA,13,Abruzzo,42.35122196,13.39843823,391,32,423,6210,6633,489,3854,554,11041,180627
5272,11,1,ITA,17,Basilicata,40.63947052,15.80514834,86,11,97,1498,1595,150,705,49,2349,104650
5273,11,1,ITA,18,Calabria,38.90597598,16.59440194,161,13,174,3188,3362,245,1831,117,5310,274781
5274,11,1,ITA,15,Campania,40.83956555,14.25084984,1416,170,1586,45592,47178,3860,11746,676,59600,669472
5275,11,1,ITA,8,Emilia-Romagna,44.49436681,11.3417208,1267,132,1399,23518,24917,1758,28033,4647,57597,858385
5276,11,1,ITA,6,Friuli Venezia Giulia,45.6494354,13.76813649,180,38,218,5158,5376,403,5470,398,11244,230864
5277,11,1,ITA,12,Lazio,41.89277044,12.48366722,2055,185,2240,33866,36106,2351,11436,1231,48773,1192749
5278,11,1,ITA,7,Liguria,44.41149315,8.9326992,1080,63,1143,7571,8714,736,18849,1781,29344,231090
5279,11,1,ITA,3,Lombardia,45.46679409,9.190347404,4246,418,4664,85411,90075,8607,96687,17589,204351,1856584
5280,11,1,ITA,11,Marche,43.61675973,13.5188753,327,42,369,6354,6723,683,7060,1021,14804,189574
5281,11,1,ITA,14,Molise,41.55774754,14.65916051,18,5,23,1030,1053,101,703,40,1796,60268
5282,11,1,ITA,21,P.A. Bolzano,46.49933453,11.35662422,273,17,290,5341,5631,534,2970,315,8916,121821
5283,11,1,ITA,22,P.A. Trento,46.06893511,11.12123097,152,9,161,1939,2100,210,6807,441,9348,114652
5284,11,1,ITA,1,Piemonte,45.0732745,7.680687483,2844,179,3023,31391,34414,2024,33852,4394,72660,643829
5285,11,1,ITA,16,Puglia,41.12559576,16.86736689,677,87,764,11268,12032,680,6539,731,19302,400285
5286,11,1,ITA,20,Sardegna,39.21531192,9.110616306,336,43,379,5999,6378,399,3218,234,9830,230042
5287,11,1,ITA,19,Sicilia,38.11569725,13.3623567,999,132,1131,14193,15324,1095,7011,518,22853,488072
5288,11,1,ITA,9,Toscana,43.76923077,11.25588885,1106,173,1279,28695,29974,2379,15305,1363,46642,736419
5289,11,1,ITA,10,Umbria,43.10675841,12.38824698,295,46,341,6869,7210,768,3602,135,10947,175572
5290,11,1,ITA,2,Valle d'Aosta,45.73750286,7.320149366,161,12,173,1747,1920,135,1281,174,3375,26164
5291,11,1,ITA,5,Veneto,45.43490485,12.33845213,832,132,964,30450,31414,2300,25421,2418,59253,910040
5292,11,2,ITA,13,Abruzzo,42.35122196,13.39843823,401,33,434,6657,7091,478,3872,556,11519,182672
5293,11,2,ITA,17,Basilicata,40.63947052,15.80514834,88,13,101,1594,1695,111,714,51,2460,106248
5294,11,2,ITA,18,Calabria,38.90597598,16.59440194,164,19,183,3422,3605,254,1841,118,5564,277221
5295,11,2,ITA,15,Campania,40.83956555,14.25084984,1486,171,1657,47113,48770,2861,12991,700,62461,680120
5296,11,2,ITA,8,Emilia-Romagna,44.49436681,11.3417208,1382,138,1520,24972,26492,1652,28093,4664,59249,865327
5297,11,2,ITA,6,Friuli Venezia Giulia,45.6494354,13.76813649,179,37,216,5337,5553,218,5506,403,11462,231668
5298,11,2,ITA,12,Lazio,41.89277044,12.48366722,2032,185,2217,35566,37783,1859,11595,1254,50632,1207323
5299,11,2,ITA,7,Liguria,44.41149315,8.9326992,1133,57,1190,8104,9294,599,18859,1790,29943,232521
5300,11,2,ITA,3,Lombardia,45.46679409,9.190347404,4406,435,4841,89577,94418,5278,97576,17635,209629,1871538
5301,11,2,ITA,11,Marche,43.61675973,13.5188753,334,50,384,6658,7042,373,7110,1025,15177,190758
5302,11,2,ITA,14,Molise,41.55774754,14.65916051,22,5,27,1126,1153,101,703,41,1897,60969
5303,11,2,ITA,21,P.A. Bolzano,46.49933453,11.35662422,293,23,316,5744,6060,437,2974,319,9353,122791
5304,11,2,ITA,22,P.A. Trento,46.06893511,11.12123097,178,11,189,1980,2169,187,6922,444,9535,115005
5305,11,2,ITA,1,Piemonte,45.0732745,7.680687483,3108,196,3304,32791,36095,2003,34153,4415,74663,652762
5306,11,2,ITA,16,Puglia,41.12559576,16.86736689,705,88,793,11776,12569,626,6619,740,19928,402022
5307,11,2,ITA,20,Sardegna,39.21531192,9.110616306,339,43,382,6271,6653,324,3266,235,10154,232724
5308,11,2,ITA,19,Sicilia,38.11569725,13.3623567,1025,142,1167,14897,16064,1024,7277,536,23877,492862
5309,11,2,ITA,9,Toscana,43.76923077,11.25588885,1217,182,1399,30336,31735,2009,15529,1387,48651,743951
5310,11,2,ITA,10,Umbria,43.10675841,12.38824698,308,46,354,6972,7326,193,3674,140,11140,175793
5311,11,2,ITA,2,Valle d'Aosta,45.73750286,7.320149366,167,12,179,1833,2012,122,1306,179,3497,26356
5312,11,2,ITA,5,Veneto,45.43490485,12.33845213,873,136,1009,31924,32933,1544,25437,2427,60797,912972
5313,11,3,ITA,13,Abruzzo,42.35122196,13.39843823,429,38,467,7180,7647,601,3909,564,12120,184865
5314,11,3,ITA,17,Basilicata,40.63947052,15.80514834,87,11,98,1681,1779,102,729,54,2562,107396
5315,11,3,ITA,18,Calabria,38.90597598,16.59440194,184,26,210,3430,3640,266,2069,121,5830,280076
5316,11,3,ITA,15,Campania,40.83956555,14.25084984,1497,227,1724,48995,50719,2971,13989,724,65432,688589
5317,11,3,ITA,8,Emilia-Romagna,44.49436681,11.3417208,1464,153,1617,26731,28348,1912,28123,4687,61158,874120
5318,11,3,ITA,6,Friuli Venezia Giulia,45.6494354,13.76813649,205,39,244,5514,5758,366,5659,411,11828,233148
5319,11,3,ITA,12,Lazio,41.89277044,12.48366722,2192,197,2389,37340,39729,2209,11837,1275,52841,1227238
5320,11,3,ITA,7,Liguria,44.41149315,8.9326992,1147,64,1211,8618,9829,1052,19356,1810,30995,235736
5321,11,3,ITA,3,Lombardia,45.46679409,9.190347404,4740,475,5215,93351,98566,6804,100115,17752,216433,1889116
5322,11,3,ITA,11,Marche,43.61675973,13.5188753,374,53,427,6990,7417,431,7160,1031,15608,192435
5323,11,3,ITA,14,Molise,41.55774754,14.65916051,24,6,30,1214,1244,93,705,41,1990,61642
5324,11,3,ITA,21,P.A. Bolzano,46.49933453,11.35662422,287,28,315,6237,6552,495,2976,320,9848,123854
5325,11,3,ITA,22,P.A. Trento,46.06893511,11.12123097,200,12,212,2050,2262,112,6938,447,9647,115196
5326,11,3,ITA,1,Piemonte,45.0732745,7.680687483,3379,213,3592,35121,38713,3169,34675,4444,77832,664753
5327,11,3,ITA,16,Puglia,41.12559576,16.86736689,749,95,844,12681,13525,1163,6813,753,21091,408246
5328,11,3,ITA,20,Sardegna,39.21531192,9.110616306,337,45,382,6526,6908,302,3309,239,10456,234643
5329,11,3,ITA,19,Sicilia,38.11569725,13.3623567,1072,150,1222,15584,16806,1048,7569,550,24925,497218
5330,11,3,ITA,9,Toscana,43.76923077,11.25588885,1261,190,1451,32466,33917,2336,15667,1403,50987,753032
5331,11,3,ITA,10,Umbria,43.10675841,12.38824698,305,48,353,7214,7567,420,3845,148,11560,178056
5332,11,3,ITA,2,Valle d'Aosta,45.73750286,7.320149366,170,13,183,1867,2050,94,1361,180,3591,26492
5333,11,3,ITA,5,Veneto,45.43490485,12.33845213,1011,142,1153,34013,35166,2298,25471,2458,63095,917684
5334,11,4,ITA,13,Abruzzo,42.35122196,13.39843823,427,36,463,7569,8032,423,3943,568,12543,186722
5335,11,4,ITA,17,Basilicata,40.63947052,15.80514834,89,15,104,1890,1994,226,740,54,2788,109034
5336,11,4,ITA,18,Calabria,38.90597598,16.59440194,212,11,223,3670,3893,262,2074,124,6092,282942
5337,11,4,ITA,15,Campania,40.83956555,14.25084984,1569,175,1744,52744,54488,4181,14386,739,69613,706058
5338,11,4,ITA,8,Emilia-Romagna,44.49436681,11.3417208,1554,161,1715,28259,29974,1758,28241,4699,62914,882474
5339,11,4,ITA,6,Friuli Venezia Giulia,45.6494354,13.76813649,215,40,255,5726,5981,436,5869,414,12264,234748
5340,11,4,ITA,12,Lazio,41.89277044,12.48366722,2317,217,2534,39349,41883,2432,12081,1309,55273,1249929
5341,11,4,ITA,7,Liguria,44.41149315,8.9326992,1196,77,1273,9194,10467,1122,19816,1834,32117,238930
5342,11,4,ITA,3,Lombardia,45.46679409,9.190347404,5018,507,5525,99208,104733,7758,101610,17848,224191,1912351
5343,11,4,ITA,11,Marche,43.61675973,13.5188753,398,54,452,7546,7998,653,7231,1032,16261,194702
5344,11,4,ITA,14,Molise,41.55774754,14.65916051,28,7,35,1207,1242,26,733,41,2016,62366
5345,11,4,ITA,21,P.A. Bolzano,46.49933453,11.35662422,309,33,342,6454,6796,249,2979,322,10097,124578
5346,11,4,ITA,22,P.A. Trento,46.06893511,11.12123097,211,11,222,2096,2318,225,7103,451,9872,115721
5347,11,4,ITA,1,Piemonte,45.0732745,7.680687483,3525,233,3758,37819,41577,3577,35351,4481,81409,675549
5348,11,4,ITA,16,Puglia,41.12559576,16.86736689,745,116,861,13372,14233,994,7089,763,22085,412674
5349,11,4,ITA,20,Sardegna,39.21531192,9.110616306,344,45,389,6659,7048,184,3351,241,10640,236425
5350,11,4,ITA,19,Sicilia,38.11569725,13.3623567,1105,148,1253,16365,17618,1155,7893,569,26080,503610
5351,11,4,ITA,9,Toscana,43.76923077,11.25588885,1319,197,1516,33948,35464,1828,15890,1445,52815,760985
5352,11,4,ITA,10,Umbria,43.10675841,12.38824698,307,49,356,7480,7836,496,4066,154,12056,180154
5353,11,4,ITA,2,Valle d'Aosta,45.73750286,7.320149366,152,11,163,1961,2124,129,1415,181,3720,26668
5354,11,4,ITA,5,Veneto,45.43490485,12.33845213,1076,149,1225,36311,37536,2436,25517,2478,65531,924415
5355,11,5,ITA,13,Abruzzo,42.35122196,13.39843823,458,36,494,7770,8264,571,4273,577,13114,188627
5356,11,5,ITA,17,Basilicata,40.63947052,15.80514834,90,16,106,2015,2121,135,746,56,2923,110599
5357,11,5,ITA,18,Calabria,38.90597598,16.59440194,217,11,228,4016,4244,358,2078,128,6450,286339
5358,11,5,ITA,15,Campania,40.83956555,14.25084984,1608,174,1782,56266,58048,3888,14697,756,73501,721021
5359,11,5,ITA,8,Emilia-Romagna,44.49436681,11.3417208,1588,177,1765,30211,31976,2180,28403,4712,65091,890032
5360,11,5,ITA,6,Friuli Venezia Giulia,45.6494354,13.76813649,268,44,312,6067,6379,546,6008,423,12810,236298
5361,11,5,ITA,12,Lazio,41.89277044,12.48366722,2508,222,2730,41560,44290,2735,12374,1344,58008,1275067
5362,11,5,ITA,7,Liguria,44.41149315,8.9326992,1236,76,1312,9911,11223,1208,20239,1863,33325,241779
5363,11,5,ITA,3,Lombardia,45.46679409,9.190347404,5318,522,5840,106684,112524,8822,102502,17987,233013,1935518
5364,11,5,ITA,11,Marche,43.61675973,13.5188753,421,56,477,8150,8627,698,7298,1034,16959,197050
5365,11,5,ITA,14,Molise,41.55774754,14.65916051,27,7,34,1301,1335,107,746,42,2123,63121
5366,11,5,ITA,21,P.A. Bolzano,46.49933453,11.35662422,335,33,368,7180,7548,762,2985,326,10859,126245
5367,11,5,ITA,22,P.A. Trento,46.06893511,11.12123097,224,15,239,2097,2336,320,7402,454,10192,116471
5368,11,5,ITA,1,Piemonte,45.0732745,7.680687483,3698,249,3947,40027,43974,3171,36086,4520,84580,687826
5369,11,5,ITA,16,Puglia,41.12559576,16.86736689,745,122,867,13956,14823,850,7323,789,22935,419182
5370,11,5,ITA,20,Sardegna,39.21531192,9.110616306,340,46,386,6982,7368,413,3438,247,11053,239432
5371,11,5,ITA,19,Sicilia,38.11569725,13.3623567,1147,157,1304,17222,18526,1322,8282,594,27402,509301
5372,11,5,ITA,9,Toscana,43.76923077,11.25588885,1387,202,1589,35893,37482,2273,16136,1470,55088,771596
5373,11,5,ITA,10,Umbria,43.10675841,12.38824698,319,50,369,8020,8389,768,4270,165,12824,182633
5374,11,5,ITA,2,Valle d'Aosta,45.73750286,7.320149366,160,12,172,1980,2152,114,1493,189,3834,26872
5375,11,5,ITA,5,Veneto,45.43490485,12.33845213,1162,164,1326,39393,40719,3264,25560,2516,68795,930576
5376,11,6,ITA,13,Abruzzo,42.35122196,13.39843823,468,42,510,8071,8581,395,4340,584,13505,190210
5377,11,6,ITA,17,Basilicata,40.63947052,15.80514834,100,16,116,2219,2335,249,778,59,3172,112020
5378,11,6,ITA,18,Calabria,38.90597598,16.59440194,212,15,227,4254,4481,264,2101,132,6714,289214
5379,11,6,ITA,15,Campania,40.83956555,14.25084984,1677,180,1857,60339,62196,4508,15017,796,78009,739433
5380,11,6,ITA,8,Emilia-Romagna,44.49436681,11.3417208,1673,177,1850,31880,33730,1953,28559,4752,67041,897938
5381,11,6,ITA,6,Friuli Venezia Giulia,45.6494354,13.76813649,260,44,304,6451,6755,542,6162,435,13352,238032
5382,11,6,ITA,12,Lazio,41.89277044,12.48366722,2511,234,2745,43939,46684,2699,12653,1370,60707,1296386
5383,11,6,ITA,7,Liguria,44.41149315,8.9326992,1315,78,1393,10299,11692,1127,20881,1879,34452,244325
5384,11,6,ITA,3,Lombardia,45.46679409,9.190347404,5563,570,6133,111233,117366,9934,107463,18118,242947,1960088
5385,11,6,ITA,11,Marche,43.61675973,13.5188753,444,60,504,8736,9240,697,7379,1037,17656,199235
5386,11,6,ITA,14,Molise,41.55774754,14.65916051,26,8,34,1371,1405,76,749,45,2199,63905
5387,11,6,ITA,21,P.A. Bolzano,46.49933453,11.35662422,356,35,391,6655,7046,713,4196,330,11572,127570
5388,11,6,ITA,22,P.A. Trento,46.06893511,11.12123097,226,17,243,2190,2433,261,7561,459,10453,117055
5389,11,6,ITA,1,Piemonte,45.0732745,7.680687483,3871,268,4139,43777,47916,4878,36993,4549,89458,703606
5390,11,6,ITA,16,Puglia,41.12559576,16.86736689,787,122,909,14720,15629,946,7450,802,23881,423213
5391,11,6,ITA,20,Sardegna,39.21531192,9.110616306,392,46,438,7248,7686,359,3477,249,11412,242502
5392,11,6,ITA,19,Sicilia,38.11569725,13.3623567,1157,159,1316,18197,19513,1423,8684,628,28825,514907
5393,11,6,ITA,9,Toscana,43.76923077,11.25588885,1303,209,1512,37928,39440,2592,16738,1502,57680,780994
5394,11,6,ITA,10,Umbria,43.10675841,12.38824698,326,53,379,8506,8885,767,4532,174,13591,185144
5395,11,6,ITA,2,Valle d'Aosta,45.73750286,7.320149366,154,13,167,2001,2168,129,1600,195,3963,27094
5396,11,6,ITA,5,Veneto,45.43490485,12.33845213,1184,169,1353,42584,43937,3297,25612,2543,72092,937280
5397,11,7,ITA,13,Abruzzo,42.35122196,13.39843823,484,43,527,8368,8895,432,4445,596,13936,191808
5398,11,7,ITA,17,Basilicata,40.63947052,15.80514834,98,15,113,2302,2415,105,799,63,3277,113188
5399,11,7,ITA,18,Calabria,38.90597598,16.59440194,227,16,243,4552,4795,392,2175,136,7106,292747
5400,11,7,ITA,15,Campania,40.83956555,14.25084984,1756,179,1935,63571,65506,4309,16001,811,82318,757092
5401,11,7,ITA,8,Emilia-Romagna,44.49436681,11.3417208,1723,188,1911,33738,35649,2009,28619,4781,69049,906435
5402,11,7,ITA,6,Friuli Venezia Giulia,45.6494354,13.76813649,286,45,331,7029,7360,872,6422,442,14224,240788
5403,11,7,ITA,12,Lazio,41.89277044,12.48366722,2619,237,2856,46180,49036,2618,12892,1397,63325,1322844
5404,11,7,ITA,7,Liguria,44.41149315,8.9326992,1303,77,1380,10728,12108,1092,21522,1914,35544,246833
5405,11,7,ITA,3,Lombardia,45.46679409,9.190347404,5813,610,6423,121206,127629,11489,108581,18226,254436,1981508
5406,11,7,ITA,11,Marche,43.61675973,13.5188753,454,67,521,9306,9827,631,7415,1045,18287,201310
5407,11,7,ITA,14,Molise,41.55774754,14.65916051,26,8,34,1523,1557,152,749,45,2351,64689
5408,11,7,ITA,21,P.A. Bolzano,46.49933453,11.35662422,361,36,397,7083,7480,773,4528,337,12345,129251
5409,11,7,ITA,22,P.A. Trento,46.06893511,11.12123097,243,18,261,2357,2618,251,7622,464,10704,117513
5410,11,7,ITA,1,Piemonte,45.0732745,7.680687483,4122,284,4406,47083,51489,4437,37812,4594,93895,715993
5411,11,7,ITA,16,Puglia,41.12559576,16.86736689,876,124,1000,15573,16573,1054,7546,816,24935,430276
5412,11,7,ITA,20,Sardegna,39.21531192,9.110616306,390,56,446,7625,8071,425,3513,253,11837,245123
5413,11,7,ITA,19,Sicilia,38.11569725,13.3623567,1161,169,1330,19407,20737,1363,8788,663,30188,520508
5414,11,7,ITA,9,Toscana,43.76923077,11.25588885,1368,214,1582,40001,41583,2787,17352,1532,60467,791081
5415,11,7,ITA,10,Umbria,43.10675841,12.38824698,345,58,403,8967,9370,688,4731,178,14279,187400
5416,11,7,ITA,2,Valle d'Aosta,45.73750286,7.320149366,154,14,168,2013,2181,117,1697,202,4080,27267
5417,11,7,ITA,5,Veneto,45.43490485,12.33845213,1300,176,1476,46181,47657,3815,25682,2568,75907,944143
5418,11,8,ITA,13,Abruzzo,42.35122196,13.39843823,484,43,527,8804,9331,584,4592,596,14519,193373
5419,11,8,ITA,17,Basilicata,40.63947052,15.80514834,102,16,118,2536,2654,246,805,64,3523,114414
5420,11,8,ITA,18,Calabria,38.90597598,16.59440194,233,16,249,4771,5020,359,2305,140,7465,295866
5421,11,8,ITA,15,Campania,40.83956555,14.25084984,1817,186,2003,67649,69652,4601,16441,826,86919,778735
5422,11,8,ITA,8,Emilia-Romagna,44.49436681,11.3417208,1836,194,2030,35822,37852,2360,28740,4816,71408,914731
5423,11,8,ITA,6,Friuli Venezia Giulia,45.6494354,13.76813649,301,45,346,7295,7641,504,6636,451,14728,242297
5424,11,8,ITA,12,Lazio,41.89277044,12.48366722,2686,237,2923,48455,51378,2489,13023,1413,65814,1341488
5425,11,8,ITA,7,Liguria,44.41149315,8.9326992,1334,81,1415,10993,12408,886,22106,1916,36430,248706
5426,11,8,ITA,3,Lombardia,45.46679409,9.190347404,6225,650,6875,125535,132410,6318,110001,18343,260754,2003397
5427,11,8,ITA,11,Marche,43.61675973,13.5188753,493,69,562,9679,10241,502,7498,1050,18789,202915
5428,11,8,ITA,14,Molise,41.55774754,14.65916051,39,7,46,1596,1642,91,752,48,2442,65390
5429,11,8,ITA,21,P.A. Bolzano,46.49933453,11.35662422,398,39,437,7550,7987,781,4798,341,13126,130323
5430,11,8,ITA,22,P.A. Trento,46.06893511,11.12123097,255,20,275,2478,2753,182,7668,465,10886,117848
5431,11,8,ITA,1,Piemonte,45.0732745,7.680687483,4367,304,4671,49526,54197,3884,38953,4629,97779,726199
5432,11,8,ITA,16,Puglia,41.12559576,16.86736689,880,123,1003,16184,17187,766,7677,837,25701,433213
5433,11,8,ITA,20,Sardegna,39.21531192,9.110616306,400,55,455,7972,8427,424,3579,255,12261,248373
5434,11,8,ITA,19,Sicilia,38.11569725,13.3623567,1250,177,1427,20040,21467,1083,9128,676,31271,525013
5435,11,8,ITA,9,Toscana,43.76923077,11.25588885,1474,226,1700,41747,43447,2479,17938,1561,62946,799345
5436,11,8,ITA,10,Umbria,43.10675841,12.38824698,353,62,415,9385,9800,660,4951,188,14939,189320
5437,11,8,ITA,2,Valle d'Aosta,45.73750286,7.320149366,158,14,172,2000,2172,55,1758,205,4135,27399
5438,11,8,ITA,5,Veneto,45.43490485,12.33845213,1355,185,1540,49430,50970,3362,25725,2574,79269,948701
5439,11,9,ITA,13,Abruzzo,42.35122196,13.39843823,513,48,561,9311,9872,625,4669,602,15143,195550
5440,11,9,ITA,17,Basilicata,40.63947052,15.80514834,111,18,129,2648,2777,132,814,64,3655,115245
5441,11,9,ITA,18,Calabria,38.90597598,16.59440194,256,16,272,5173,5445,443,2319,144,7908,298062
5442,11,9,ITA,15,Campania,40.83956555,14.25084984,1949,191,2140,70180,72320,3120,16875,844,90039,789173
5443,11,9,ITA,8,Emilia-Romagna,44.49436681,11.3417208,1939,204,2143,37487,39630,2025,28978,4824,73432,922303
5444,11,9,ITA,6,Friuli Venezia Giulia,45.6494354,13.76813649,319,46,365,7467,7832,320,6760,456,15048,243252
5445,11,9,ITA,12,Lazio,41.89277044,12.48366722,2761,237,2998,50276,53274,2153,13264,1429,67967,1357006
5446,11,9,ITA,7,Liguria,44.41149315,8.9326992,1387,92,1479,11242,12721,538,22310,1937,36968,249942
5447,11,9,ITA,3,Lombardia,45.46679409,9.190347404,6414,670,7084,124375,131459,4777,115630,18442,265531,2014134
5448,11,9,ITA,11,Marche,43.61675973,13.5188753,519,71,590,9861,10451,262,7543,1057,19051,203665
5449,11,9,ITA,14,Molise,41.55774754,14.65916051,38,7,45,1615,1660,98,831,49,2540,66276
5450,11,9,ITA,21,P.A. Bolzano,46.49933453,11.35662422,411,41,452,7962,8414,583,4950,345,13709,131696
5451,11,9,ITA,22,P.A. Trento,46.06893511,11.12123097,275,24,299,2675,2974,257,7698,471,11143,118318
5452,11,9,ITA,1,Piemonte,45.0732745,7.680687483,4540,312,4852,51404,56256,2876,39721,4678,100655,735109
5453,11,9,ITA,16,Puglia,41.12559576,16.86736689,968,119,1087,16726,17813,730,7774,844,26431,437142
5454,11,9,ITA,20,Sardegna,39.21531192,9.110616306,408,58,466,8127,8593,327,3727,268,12588,250888
5455,11,9,ITA,19,Sicilia,38.11569725,13.3623567,1303,187,1490,20449,21939,1023,9652,703,32294,529908
5456,11,9,ITA,9,Toscana,43.76923077,11.25588885,1542,234,1776,42704,44480,2244,19116,1594,65190,806480
5457,11,9,ITA,10,Umbria,43.10675841,12.38824698,360,64,424,9572,9996,314,5060,197,15253,189991
5458,11,9,ITA,2,Valle d'Aosta,45.73750286,7.320149366,159,15,174,2092,2266,201,1863,207,4336,27671
5459,11,9,ITA,5,Veneto,45.43490485,12.33845213,1464,195,1659,51503,53162,2223,25735,2595,81492,953936
5460,11,10,ITA,13,Abruzzo,42.35122196,13.39843823,530,46,576,9852,10428,746,4832,628,15888,197902
5461,11,10,ITA,17,Basilicata,40.63947052,15.80514834,138,18,156,2831,2987,224,826,66,3879,116796
5462,11,10,ITA,18,Calabria,38.90597598,16.59440194,283,19,302,5545,5847,409,2319,151,8317,301133
5463,11,10,ITA,15,Campania,40.83956555,14.25084984,2061,193,2254,71974,74228,2716,17665,862,92755,800240
5464,11,10,ITA,8,Emilia-Romagna,44.49436681,11.3417208,2020,215,2235,39545,41780,2430,29230,4845,75855,931259
5465,11,10,ITA,6,Friuli Venezia Giulia,45.6494354,13.76813649,336,47,383,7458,7841,482,7213,476,15530,245027
5466,11,10,ITA,12,Lazio,41.89277044,12.48366722,2785,257,3042,52547,55589,2608,13521,1465,70575,1381230
5467,11,10,ITA,7,Liguria,44.41149315,8.9326992,1315,92,1407,11929,13336,1172,22828,1976,38140,253455
5468,11,10,ITA,3,Lombardia,45.46679409,9.190347404,6682,708,7390,128115,135505,10955,122410,18571,276486,2039672
5469,11,10,ITA,11,Marche,43.61675973,13.5188753,525,75,600,10289,10889,504,7599,1067,19555,205090
5470,11,10,ITA,14,Molise,41.55774754,14.65916051,44,7,51,1641,1692,42,834,56,2582,66672
5471,11,10,ITA,21,P.A. Bolzano,46.49933453,11.35662422,427,37,464,8199,8663,375,5071,350,14084,132488
5472,11,10,ITA,22,P.A. Trento,46.06893511,11.12123097,290,28,318,2491,2809,243,8100,477,11386,118965
5473,11,10,ITA,1,Piemonte,45.0732745,7.680687483,4715,325,5040,53795,58835,3659,40737,4742,104314,745706
5474,11,10,ITA,16,Puglia,41.12559576,16.86736689,1029,131,1160,17726,18886,1245,7921,869,27676,443227
5475,11,10,ITA,20,Sardegna,39.21531192,9.110616306,403,51,454,8506,8960,489,3838,279,13077,254265
5476,11,10,ITA,19,Sicilia,38.11569725,13.3623567,1348,195,1543,21289,22832,1201,9928,735,33495,535921
5477,11,10,ITA,9,Toscana,43.76923077,11.25588885,1582,242,1824,44490,46314,2223,19451,1648,67413,813816
5478,11,10,ITA,10,Umbria,43.10675841,12.38824698,363,66,429,9711,10140,485,5392,206,15738,192401
5479,11,10,ITA,2,Valle d'Aosta,45.73750286,7.320149366,161,15,176,2123,2299,127,1946,218,4463,27907
5480,11,10,ITA,5,Veneto,45.43490485,12.33845213,1596,204,1800,48450,50250,2763,31362,2643,84255,962389
5481,11,11,ITA,13,Abruzzo,42.35122196,13.39843823,546,51,597,10353,10950,662,4956,644,16550,199985
5482,11,11,ITA,17,Basilicata,40.63947052,15.80514834,133,19,152,2996,3148,168,830,69,4047,118262
5483,11,11,ITA,18,Calabria,38.90597598,16.59440194,286,18,304,5833,6137,376,2400,156,8693,304484
5484,11,11,ITA,15,Campania,40.83956555,14.25084984,2077,181,2258,74412,76670,3166,18355,896,95921,815377
5485,11,11,ITA,8,Emilia-Romagna,44.49436681,11.3417208,2072,222,2294,41597,43891,2428,29516,4876,78283,939211
5486,11,11,ITA,6,Friuli Venezia Giulia,45.6494354,13.76813649,346,46,392,7773,8165,572,7448,489,16102,246668
5487,11,11,ITA,12,Lazio,41.89277044,12.48366722,2913,255,3168,54415,57583,2479,13968,1503,73054,1403357
5488,11,11,ITA,7,Liguria,44.41149315,8.9326992,1315,98,1413,12542,13955,1102,23278,2009,39242,256277
5489,11,11,ITA,3,Lombardia,45.46679409,9.190347404,6907,764,7671,134247,141918,8180,124025,18723,284666,2066395
5490,11,11,ITA,11,Marche,43.61675973,13.5188753,536,74,610,10904,11514,701,7665,1077,20256,207157
5491,11,11,ITA,14,Molise,41.55774754,14.65916051,48,8,56,1700,1756,71,840,57,2653,67422
5492,11,11,ITA,21,P.A. Bolzano,46.49933453,11.35662422,427,37,464,8421,8885,386,5226,359,14470,133275
5493,11,11,ITA,22,P.A. Trento,46.06893511,11.12123097,307,31,338,2449,2787,253,8367,485,11639,119756
5494,11,11,ITA,1,Piemonte,45.0732745,7.680687483,4790,340,5130,55224,60354,2953,42087,4826,107267,755259
5495,11,11,ITA,16,Puglia,41.12559576,16.86736689,1131,142,1273,18826,20099,1332,8013,896,29008,448063
5496,11,11,ITA,20,Sardegna,39.21531192,9.110616306,418,54,472,8709,9181,416,4019,293,13493,257715
5497,11,11,ITA,19,Sicilia,38.11569725,13.3623567,1376,202,1578,21986,23564,1487,10656,762,34982,541877
5498,11,11,ITA,9,Toscana,43.76923077,11.25588885,1628,246,1874,46026,47900,2507,20319,1701,69920,822966
5499,11,11,ITA,10,Umbria,43.10675841,12.38824698,359,68,427,9907,10334,515,5701,218,16253,194467
5500,11,11,ITA,2,Valle d'Aosta,45.73750286,7.320149366,160,17,177,2155,2332,125,2031,225,4588,28237
5501,11,11,ITA,5,Veneto,45.43490485,12.33845213,1669,208,1877,50358,52235,3082,32413,2689,87337,965761
5502,11,12,ITA,13,Abruzzo,42.35122196,13.39843823,547,52,599,10817,11416,541,5029,646,17091,200964
5503,11,12,ITA,17,Basilicata,40.63947052,15.80514834,134,19,153,3187,3340,202,837,72,4249,119885
5504,11,12,ITA,18,Calabria,38.90597598,16.59440194,298,21,319,6241,6560,426,2402,157,9119,307797
5505,11,12,ITA,15,Campania,40.83956555,14.25084984,1944,192,2136,77923,80059,4065,19000,927,99986,834920
5506,11,12,ITA,8,Emilia-Romagna,44.49436681,11.3417208,2094,228,2322,43702,46024,2402,29735,4925,80684,947920
5507,11,12,ITA,6,Friuli Venezia Giulia,45.6494354,13.76813649,346,47,393,8254,8647,838,7795,498,16940,248809
5508,11,12,ITA,12,Lazio,41.89277044,12.48366722,2953,259,3212,56707,59919,2686,14269,1552,75740,1425173
5509,11,12,ITA,7,Liguria,44.41149315,8.9326992,1363,109,1472,13189,14661,1013,23554,2040,40255,258621
5510,11,12,ITA,3,Lombardia,45.46679409,9.190347404,7047,782,7829,134964,142793,9291,132254,18910,293957,2086645
5511,11,12,ITA,11,Marche,43.61675973,13.5188753,536,74,610,11602,12212,834,7795,1083,21090,209704
5512,11,12,ITA,14,Molise,41.55774754,14.65916051,55,7,62,1762,1824,73,841,61,2726,68089
5513,11,12,ITA,21,P.A. Bolzano,46.49933453,11.35662422,448,42,490,8745,9235,694,5564,365,15164,134708
5514,11,12,ITA,22,P.A. Trento,46.06893511,11.12123097,338,30,368,2465,2833,253,8566,493,11892,120443
5515,11,12,ITA,1,Piemonte,45.0732745,7.680687483,4833,348,5181,58017,63198,4787,43953,4903,112054,770475
5516,11,12,ITA,16,Puglia,41.12559576,16.86736689,1193,145,1338,19917,21255,1434,8252,935,30442,453311
5517,11,12,ITA,20,Sardegna,39.21531192,9.110616306,424,56,480,8891,9371,301,4125,298,13794,260989
5518,11,12,ITA,19,Sicilia,38.11569725,13.3623567,1391,205,1596,23318,24914,1692,10958,802,36674,548214
5519,11,12,ITA,9,Toscana,43.76923077,11.25588885,1653,256,1909,47007,48916,1932,21198,1738,71852,830926
5520,11,12,ITA,10,Umbria,43.10675841,12.38824698,354,69,423,10361,10784,783,6026,226,17036,197139
5521,11,12,ITA,2,Valle d'Aosta,45.73750286,7.320149366,159,16,175,2163,2338,167,2186,231,4755,28810
5522,11,12,ITA,5,Veneto,45.43490485,12.33845213,1763,213,1976,52779,54755,3564,33419,2727,90901,971907
5523,11,13,ITA,13,Abruzzo,42.35122196,13.39843823,567,57,624,11284,11908,683,5205,661,17774,203208
5524,11,13,ITA,17,Basilicata,40.63947052,15.80514834,141,23,164,3436,3600,307,883,73,4556,122141
5525,11,13,ITA,18,Calabria,38.90597598,16.59440194,338,27,365,6312,6677,297,2575,164,9416,310710
5526,11,13,ITA,15,Campania,40.83956555,14.25084984,2153,183,2336,80884,83220,4079,19878,967,104065,854598
5527,11,13,ITA,8,Emilia-Romagna,44.49436681,11.3417208,2164,225,2389,45767,48156,2384,29947,4965,83068,956466
5528,11,13,ITA,6,Friuli Venezia Giulia,45.6494354,13.76813649,366,47,413,8738,9151,831,8114,506,17771,250805
5529,11,13,ITA,12,Lazio,41.89277044,12.48366722,3018,260,3278,59121,62399,2925,14680,1586,78665,1446989
5530,11,13,ITA,7,Liguria,44.41149315,8.9326992,1372,110,1482,13403,14885,1209,24521,2058,41464,261534
5531,11,13,ITA,3,Lombardia,45.46679409,9.190347404,7319,801,8120,143149,151269,10634,134294,19028,304591,2115026
5532,11,13,ITA,11,Marche,43.61675973,13.5188753,559,74,633,12201,12834,740,7902,1094,21830,211777
5533,11,13,ITA,14,Molise,41.55774754,14.65916051,55,7,62,1817,1879,63,848,62,2789,68894
5534,11,13,ITA,21,P.A. Bolzano,46.49933453,11.35662422,453,41,494,9220,9714,820,5896,374,15984,135924
5535,11,13,ITA,22,P.A. Trento,46.06893511,11.12123097,353,30,383,2537,2920,202,8669,505,12094,120800
5536,11,13,ITA,1,Piemonte,45.0732745,7.680687483,4890,353,5243,61411,66654,5258,45694,4964,117312,785558
5537,11,13,ITA,16,Puglia,41.12559576,16.86736689,1249,158,1407,21104,22511,1350,8324,957,31792,459534
5538,11,13,ITA,20,Sardegna,39.21531192,9.110616306,472,57,529,9164,9693,623,4411,313,14417,265279
5539,11,13,ITA,19,Sicilia,38.11569725,13.3623567,1450,210,1660,24626,26286,1707,11258,837,38381,554557
5540,11,13,ITA,9,Toscana,43.76923077,11.25588885,1656,265,1921,48208,50129,2478,22408,1793,74330,839613
5541,11,13,ITA,10,Umbria,43.10675841,12.38824698,359,68,427,9963,10390,604,7016,234,17640,199394
5542,11,13,ITA,2,Valle d'Aosta,45.73750286,7.320149366,149,15,164,2199,2363,103,2261,234,4858,29189
5543,11,13,ITA,5,Veneto,45.43490485,12.33845213,1831,219,2050,55238,57288,3605,34454,2764,94506,978328
5544,11,14,ITA,13,Abruzzo,42.35122196,13.39843823,545,59,604,12018,12622,939,5420,671,18713,205812
5545,11,14,ITA,17,Basilicata,40.63947052,15.80514834,144,21,165,3668,3833,265,910,78,4821,124396
5546,11,14,ITA,18,Calabria,38.90597598,16.59440194,345,26,371,6615,6986,333,2594,169,9749,314068
5547,11,14,ITA,15,Campania,40.83956555,14.25084984,2080,184,2264,82982,85246,3351,21176,994,107416,872094
5548,11,14,ITA,8,Emilia-Romagna,44.49436681,11.3417208,2243,231,2474,48088,50562,2637,30129,5008,85699,965000
5549,11,14,ITA,6,Friuli Venezia Giulia,45.6494354,13.76813649,378,45,423,9106,9529,558,8284,516,18329,252095
5550,11,14,ITA,12,Lazio,41.89277044,12.48366722,3076,273,3349,61609,64958,2997,15079,1625,81662,1471685
5551,11,14,ITA,7,Liguria,44.41149315,8.9326992,1402,108,1510,13824,15334,1091,25133,2088,42555,264030
5552,11,14,ITA,3,Lombardia,45.46679409,9.190347404,7621,817,8438,147841,156279,8129,137255,19186,312720,2135880
5553,11,14,ITA,11,Marche,43.61675973,13.5188753,484,74,558,12861,13419,779,8088,1102,22609,214152
5554,11,14,ITA,14,Molise,41.55774754,14.65916051,55,6,61,1869,1930,121,914,66,2910,69735
5555,11,14,ITA,21,P.A. Bolzano,46.49933453,11.35662422,456,44,500,9559,10059,690,6236,379,16674,137003
5556,11,14,ITA,22,P.A. Trento,46.06893511,11.12123097,355,31,386,2448,2834,206,8950,516,12300,121696
5557,11,14,ITA,1,Piemonte,45.0732745,7.680687483,4902,360,5262,63953,69215,4471,47567,5001,121783,798081
5558,11,14,ITA,16,Puglia,41.12559576,16.86736689,1289,178,1467,22533,24000,1741,8560,973,33533,466554
5559,11,14,ITA,20,Sardegna,39.21531192,9.110616306,506,59,565,9417,9982,396,4513,318,14813,268876
5560,11,14,ITA,19,Sicilia,38.11569725,13.3623567,1462,215,1677,26129,27806,1729,11444,860,40110,560736
5561,11,14,ITA,9,Toscana,43.76923077,11.25588885,1679,266,1945,49116,51061,2420,23854,1835,76750,848164
5562,11,14,ITA,10,Umbria,43.10675841,12.38824698,361,68,429,10347,10776,579,7201,242,18219,201299
5563,11,14,ITA,2,Valle d'Aosta,45.73750286,7.320149366,146,13,159,2140,2299,245,2564,240,5103,29478
5564,11,14,ITA,5,Veneto,45.43490485,12.33845213,1869,228,2097,57608,59705,3578,35563,2816,98084,984607
5565,11,15,ITA,13,Abruzzo,42.35122196,13.39843823,565,59,624,12410,13034,470,5469,679,19182,207477
5566,11,15,ITA,17,Basilicata,40.63947052,15.80514834,155,26,181,3788,3969,158,931,79,4979,125928
5567,11,15,ITA,18,Calabria,38.90597598,16.59440194,342,41,383,6656,7039,344,2880,174,10093,316589
5568,11,15,ITA,15,Campania,40.83956555,14.25084984,2224,194,2418,85839,88257,3771,21901,1029,111187,891617
5569,11,15,ITA,8,Emilia-Romagna,44.49436681,11.3417208,2285,246,2531,50670,53201,2822,30275,5044,88520,972719
5570,11,15,ITA,6,Friuli Venezia Giulia,45.6494354,13.76813649,401,43,444,9483,9927,608,8482,528,18937,253332
5571,11,15,ITA,12,Lazio,41.89277044,12.48366722,3159,274,3433,63876,67309,2612,15319,1646,84274,1490435
5572,11,15,ITA,7,Liguria,44.41149315,8.9326992,1393,115,1508,14230,15738,822,25530,2109,43377,265754
5573,11,15,ITA,3,Lombardia,45.46679409,9.190347404,7781,837,8618,153923,162541,8060,138872,19367,320780,2152870
5574,11,15,ITA,11,Marche,43.61675973,13.5188753,483,77,560,13489,14049,707,8156,1111,23316,216441
5575,11,15,ITA,14,Molise,41.55774754,14.65916051,60,7,67,1945,2012,85,916,67,2995,70623
5576,11,15,ITA,21,P.A. Bolzano,46.49933453,11.35662422,479,43,522,9768,10290,628,6614,398,17302,137933
5577,11,15,ITA,22,P.A. Trento,46.06893511,11.12123097,370,33,403,2559,2962,268,9082,524,12568,122282
5578,11,15,ITA,1,Piemonte,45.0732745,7.680687483,4921,372,5293,65936,71229,3682,49190,5046,125465,806208
5579,11,15,ITA,16,Puglia,41.12559576,16.86736689,1261,180,1441,23261,24702,905,8751,985,34438,469846
5580,11,15,ITA,20,Sardegna,39.21531192,9.110616306,510,60,570,9650,10220,370,4641,322,15183,271440
5581,11,15,ITA,19,Sicilia,38.11569725,13.3623567,1476,217,1693,27114,28807,1422,11829,896,41532,565253
5582,11,15,ITA,9,Toscana,43.76923077,11.25588885,1734,274,2008,50300,52308,2653,25216,1879,79403,856660
5583,11,15,ITA,10,Umbria,43.10675841,12.38824698,366,71,437,10658,11095,657,7528,253,18876,203439
5584,11,15,ITA,2,Valle d'Aosta,45.73750286,7.320149366,148,12,160,2135,2295,143,2703,248,5246,29683
5585,11,15,ITA,5,Veneto,45.43490485,12.33845213,1934,241,2175,59331,61506,2792,36525,2845,100876,989643
5586,11,16,ITA,13,Abruzzo,42.35122196,13.39843823,571,59,630,12869,13499,642,5634,690,19823,209407
5587,11,16,ITA,17,Basilicata,40.63947052,15.80514834,140,27,167,3905,4072,127,949,85,5106,126804
5588,11,16,ITA,18,Calabria,38.90597598,16.59440194,358,45,403,6865,7268,297,2942,180,10390,318237
5589,11,16,ITA,15,Campania,40.83956555,14.25084984,2190,192,2382,89132,91514,4079,22686,1066,115266,912270
5590,11,16,ITA,8,Emilia-Romagna,44.49436681,11.3417208,2393,247,2640,52789,55429,2547,30570,5067,91066,980006
5591,11,16,ITA,6,Friuli Venezia Giulia,45.6494354,13.76813649,407,47,454,9601,10055,456,8792,546,19393,254630
5592,11,16,ITA,12,Lazio,41.89277044,12.48366722,3099,278,3377,65893,69270,2407,15731,1680,86681,1503973
5593,11,16,ITA,7,Liguria,44.41149315,8.9326992,1381,111,1492,14409,15901,365,25717,2124,43742,266634
5594,11,16,ITA,3,Lombardia,45.46679409,9.190347404,7901,855,8756,143583,152339,4128,153103,19466,324908,2160155
5595,11,16,ITA,11,Marche,43.61675973,13.5188753,499,78,577,13634,14211,282,8268,1119,23598,217369
5596,11,16,ITA,14,Molise,41.55774754,14.65916051,56,7,63,2019,2082,126,968,71,3121,71476
5597,11,16,ITA,21,P.A. Bolzano,46.49933453,11.35662422,487,43,530,10038,10568,544,6873,405,17846,138774
5598,11,16,ITA,22,P.A. Trento,46.06893511,11.12123097,386,32,418,2420,2838,181,9372,539,12749,123110
5599,11,16,ITA,1,Piemonte,45.0732745,7.680687483,5074,378,5452,67488,72940,3476,50884,5117,128941,815862
5600,11,16,ITA,16,Puglia,41.12559576,16.86736689,1295,182,1477,24048,25525,1044,8936,1021,35482,472227
5601,11,16,ITA,20,Sardegna,39.21531192,9.110616306,510,63,573,9881,10454,411,4812,328,15594,273343
5602,11,16,ITA,19,Sicilia,38.11569725,13.3623567,1501,224,1725,28040,29765,1461,12296,932,42993,570817
5603,11,16,ITA,9,Toscana,43.76923077,11.25588885,1777,284,2061,51790,53851,2433,26070,1915,81836,863173
5604,11,16,ITA,10,Umbria,43.10675841,12.38824698,375,72,447,10792,11239,283,7658,262,19159,203887
5605,11,16,ITA,2,Valle d'Aosta,45.73750286,7.320149366,151,16,167,2099,2266,99,2826,253,5345,29915
5606,11,16,ITA,5,Veneto,45.43490485,12.33845213,1985,252,2237,60461,62698,1966,37277,2867,102842,993185
5607,11,17,ITA,13,Abruzzo,42.35122196,13.39843823,590,66,656,13352,14008,729,5841,703,20552,211733
5608,11,17,ITA,17,Basilicata,40.63947052,15.80514834,150,30,180,4146,4326,269,964,85,5375,129135
5609,11,17,ITA,18,Calabria,38.90597598,16.59440194,353,53,406,7332,7738,680,3145,187,11070,320121
5610,11,17,ITA,15,Campania,40.83956555,14.25084984,2236,201,2437,90289,92726,3019,24474,1085,118285,925004
5611,11,17,ITA,8,Emilia-Romagna,44.49436681,11.3417208,2451,247,2698,54570,57268,2219,30902,5115,93285,988202
5612,11,17,ITA,6,Friuli Venezia Giulia,45.6494354,13.76813649,454,44,498,9923,10421,536,8952,556,19929,255770
5613,11,17,ITA,12,Lazio,41.89277044,12.48366722,3066,308,3374,67881,71255,2538,16225,1739,89219,1524981
5614,11,17,ITA,7,Liguria,44.41149315,8.9326992,1393,117,1510,15021,16531,685,25752,2144,44427,268832
5615,11,17,ITA,3,Lombardia,45.46679409,9.190347404,8151,894,9045,147522,156567,8448,157121,19668,333356,2177539
5616,11,17,ITA,11,Marche,43.61675973,13.5188753,525,78,603,13908,14511,357,8314,1130,23955,218598
5617,11,17,ITA,14,Molise,41.55774754,14.65916051,60,9,69,2132,2201,147,995,72,3268,72214
5618,11,17,ITA,21,P.A. Bolzano,46.49933453,11.35662422,482,44,526,10175,10701,258,6989,414,18104,139217
5619,11,17,ITA,22,P.A. Trento,46.06893511,11.12123097,388,35,423,2571,2994,276,9489,542,13025,123724
5620,11,17,ITA,1,Piemonte,45.0732745,7.680687483,5150,384,5534,68252,73786,2606,52571,5190,131547,826436
5621,11,17,ITA,16,Puglia,41.12559576,16.86736689,1316,181,1497,25110,26607,1234,9052,1057,36716,477865
5622,11,17,ITA,20,Sardegna,39.21531192,9.110616306,512,64,576,10208,10784,502,4972,340,16096,276049
5623,11,17,ITA,19,Sicilia,38.11569725,13.3623567,1505,227,1732,29024,30756,1698,12964,971,44691,577818
5624,11,17,ITA,9,Toscana,43.76923077,11.25588885,1792,277,2069,52083,54152,2361,28078,1967,84197,870134
5625,11,17,ITA,10,Umbria,43.10675841,12.38824698,368,70,438,10806,11244,351,7991,275,19510,206060
5626,11,17,ITA,2,Valle d'Aosta,45.73750286,7.320149366,152,17,169,1994,2163,154,3079,257,5499,30178
5627,11,17,ITA,5,Veneto,45.43490485,12.33845213,1980,266,2246,60825,63071,3124,39928,2967,105966,1000577
5628,11,18,ITA,13,Abruzzo,42.35122196,13.39843823,621,65,686,13704,14390,641,6091,712,21193,213814
5629,11,18,ITA,17,Basilicata,40.63947052,15.80514834,144,28,172,4332,4504,237,1009,99,5612,131191
5630,11,18,ITA,18,Calabria,38.90597598,16.59440194,388,46,434,8097,8531,936,3278,197,12006,324783
5631,11,18,ITA,15,Campania,40.83956555,14.25084984,2259,200,2459,92680,95139,3657,25643,1160,121942,944638
5632,11,18,ITA,8,Emilia-Romagna,44.49436681,11.3417208,2449,244,2693,56626,59319,2371,31167,5168,95654,995472
5633,11,18,ITA,6,Friuli Venezia Giulia,45.6494354,13.76813649,470,49,519,10235,10754,796,9404,567,20725,257516
5634,11,18,ITA,12,Lazio,41.89277044,12.48366722,3056,318,3374,70117,73491,2866,16775,1819,92085,1546539
5635,11,18,ITA,7,Liguria,44.41149315,8.9326992,1371,118,1489,15279,16768,775,26271,2163,45202,271234
5636,11,18,ITA,3,Lombardia,45.46679409,9.190347404,8323,903,9226,142857,152083,7633,169056,19850,340989,2193319
5637,11,18,ITA,11,Marche,43.61675973,13.5188753,527,79,606,14147,14753,479,8542,1139,24434,220387
5638,11,18,ITA,14,Molise,41.55774754,14.65916051,58,7,65,2002,2067,98,1219,80,3366,73076
5639,11,18,ITA,21,P.A. Bolzano,46.49933453,11.35662422,481,39,520,10381,10901,581,7359,425,18685,140362
5640,11,18,ITA,22,P.A. Trento,46.06893511,11.12123097,398,38,436,2424,2860,236,9852,549,13261,124544
5641,11,18,ITA,1,Piemonte,45.0732745,7.680687483,5208,388,5596,69468,75064,3281,54511,5253,134828,836881
5642,11,18,ITA,16,Puglia,41.12559576,16.86736689,1320,198,1518,26096,27614,1368,9385,1085,38084,483912
5643,11,18,ITA,20,Sardegna,39.21531192,9.110616306,505,63,568,10477,11045,422,5123,350,16518,278979
5644,11,18,ITA,19,Sicilia,38.11569725,13.3623567,1528,240,1768,30334,32102,1837,13411,1015,46528,582685
5645,11,18,ITA,9,Toscana,43.76923077,11.25588885,1805,282,2087,52023,54110,2508,30573,2022,86705,880609
5646,11,18,ITA,10,Umbria,43.10675841,12.38824698,368,74,442,10832,11274,501,8451,286,20011,208149
5647,11,18,ITA,2,Valle d'Aosta,45.73750286,7.320149366,146,17,163,1930,2093,87,3234,259,5586,30337
5648,11,18,ITA,5,Veneto,45.43490485,12.33845213,2079,274,2353,61953,64306,2972,41613,3019,108938,1005997
5649,11,19,ITA,13,Abruzzo,42.35122196,13.39843823,658,74,732,14130,14862,649,6259,721,21842,215944
5650,11,19,ITA,17,Basilicata,40.63947052,15.80514834,147,28,175,4587,4762,271,1020,101,5883,133335
5651,11,19,ITA,18,Calabria,38.90597598,16.59440194,395,47,442,8536,8978,506,3332,202,12512,327394
5652,11,19,ITA,15,Campania,40.83956555,14.25084984,2287,194,2481,93705,96186,3334,27898,1192,125276,956035
5653,11,19,ITA,8,Emilia-Romagna,44.49436681,11.3417208,2489,244,2733,58276,61009,2160,31587,5218,97814,1003409
5654,11,19,ITA,6,Friuli Venezia Giulia,45.6494354,13.76813649,485,48,533,11112,11645,1197,9697,580,21922,259446
5655,11,19,ITA,12,Lazio,41.89277044,12.48366722,3103,329,3432,72109,75541,2697,17361,1880,94782,1570432
5656,11,19,ITA,7,Liguria,44.41149315,8.9326992,1319,119,1438,15589,17027,792,26789,2178,45994,273332
5657,11,19,ITA,3,Lombardia,45.46679409,9.190347404,8291,915,9206,146374,155580,7453,172847,20015,348442,2208742
5658,11,19,ITA,11,Marche,43.61675973,13.5188753,526,78,604,14252,14856,667,9095,1150,25101,222600
5659,11,19,ITA,14,Molise,41.55774754,14.65916051,66,8,74,2125,2199,154,1237,84,3520,74113
5660,11,19,ITA,21,P.A. Bolzano,46.49933453,11.35662422,469,39,508,10696,11204,696,7739,438,19381,141552
5661,11,19,ITA,22,P.A. Trento,46.06893511,11.12123097,407,39,446,2540,2986,266,9985,556,13527,125144
5662,11,19,ITA,1,Piemonte,45.0732745,7.680687483,5147,390,5537,71700,77237,5349,57609,5331,140177,865428
5663,11,19,ITA,16,Puglia,41.12559576,16.86736689,1324,200,1524,26976,28500,1263,9734,1113,39347,491204
5664,11,19,ITA,20,Sardegna,39.21531192,9.110616306,517,67,584,10808,11392,479,5243,362,16997,283137
5665,11,19,ITA,19,Sicilia,38.11569725,13.3623567,1532,240,1772,31809,33581,1871,13763,1055,48399,590160
5666,11,19,ITA,9,Toscana,43.76923077,11.25588885,1814,287,2101,52023,54124,1972,32480,2073,88677,888853
5667,11,19,ITA,10,Umbria,43.10675841,12.38824698,369,75,444,10941,11385,556,8889,293,20567,210121
5668,11,19,ITA,2,Valle d'Aosta,45.73750286,7.320149366,144,12,156,1879,2035,91,3371,271,5677,30688
5669,11,19,ITA,5,Veneto,45.43490485,12.33845213,2121,279,2400,64182,66582,3753,43052,3057,112691,1011752
5670,11,20,ITA,13,Abruzzo,42.35122196,13.39843823,661,75,736,14642,15378,705,6430,739,22547,218064
5671,11,20,ITA,17,Basilicata,40.63947052,15.80514834,154,27,181,4762,4943,219,1055,104,6102,135426
5672,11,20,ITA,18,Calabria,38.90597598,16.59440194,415,46,461,8906,9367,515,3447,213,13027,330399
5673,11,20,ITA,15,Campania,40.83956555,14.25084984,2244,201,2445,96547,98992,4226,29293,1217,129502,972976
5674,11,20,ITA,8,Emilia-Romagna,44.49436681,11.3417208,2534,244,2778,60156,62934,2533,32145,5265,100344,1011858
5675,11,20,ITA,6,Friuli Venezia Giulia,45.6494354,13.76813649,505,54,559,11616,12175,1018,10157,608,22940,261532
5676,11,20,ITA,12,Lazio,41.89277044,12.48366722,3202,337,3539,74207,77746,2667,17782,1921,97449,1592354
5677,11,20,ITA,7,Liguria,44.41149315,8.9326992,1290,120,1410,14544,15954,761,28594,2207,46755,275463
5678,11,20,ITA,3,Lombardia,45.46679409,9.190347404,8304,930,9234,150407,159641,9221,177832,20190,357663,2221955
5679,11,20,ITA,11,Marche,43.61675973,13.5188753,542,81,623,14354,14977,512,9475,1161,25613,224325
5680,11,20,ITA,14,Molise,41.55774754,14.65916051,52,8,60,2111,2171,139,1402,86,3659,75410
5681,11,20,ITA,21,P.A. Bolzano,46.49933453,11.35662422,468,38,506,11005,11511,736,8160,446,20117,142658
5682,11,20,ITA,22,P.A. Trento,46.06893511,11.12123097,417,38,455,2549,3004,234,10194,563,13761,125701
5683,11,20,ITA,1,Piemonte,45.0732745,7.680687483,5225,393,5618,70927,76545,3861,62074,5419,144038,875229
5684,11,20,ITA,16,Puglia,41.12559576,16.86736689,1408,202,1610,27824,29434,1456,10240,1129,40803,495932
5685,11,20,ITA,20,Sardegna,39.21531192,9.110616306,526,69,595,11049,11644,581,5567,367,17578,286870
5686,11,20,ITA,19,Sicilia,38.11569725,13.3623567,1537,242,1779,32977,34756,1634,14179,1098,50033,596565
5687,11,20,ITA,9,Toscana,43.76923077,11.25588885,1792,295,2087,51782,53869,2207,34894,2121,90884,897193
5688,11,20,ITA,10,Umbria,43.10675841,12.38824698,363,71,434,10934,11368,394,9279,314,20961,211832
5689,11,20,ITA,2,Valle d'Aosta,45.73750286,7.320149366,148,10,158,1922,2080,155,3474,278,5832,30994
5690,11,20,ITA,5,Veneto,45.43490485,12.33845213,2170,267,2437,66250,68687,3468,44349,3123,116159,1016938
5691,11,21,ITA,13,Abruzzo,42.35122196,13.39843823,676,73,749,14848,15597,541,6717,774,23088,219918
5692,11,21,ITA,17,Basilicata,40.63947052,15.80514834,157,24,181,4989,5170,260,1082,110,6362,137110
5693,11,21,ITA,18,Calabria,38.90597598,16.59440194,426,45,471,9317,9788,425,3447,217,13452,333246
5694,11,21,ITA,15,Campania,40.83956555,14.25084984,2260,198,2458,98677,101135,3554,30672,1249,133056,985270
5695,11,21,ITA,8,Emilia-Romagna,44.49436681,11.3417208,2594,241,2835,62245,65080,2723,32672,5312,103064,1019829
5696,11,21,ITA,6,Friuli Venezia Giulia,45.6494354,13.76813649,509,55,564,12193,12757,1043,10593,633,23983,263440
5697,11,21,ITA,12,Lazio,41.89277044,12.48366722,3257,337,3594,76282,79876,2658,18273,1958,100107,1617550
5698,11,21,ITA,7,Liguria,44.41149315,8.9326992,1241,119,1360,14513,15873,761,29416,2227,47516,277654
5699,11,21,ITA,3,Lombardia,45.46679409,9.190347404,8314,936,9250,153435,162685,8853,183472,20359,366516,2236696
5700,11,21,ITA,11,Marche,43.61675973,13.5188753,544,86,630,14492,15122,452,9775,1168,26065,225892
5701,11,21,ITA,14,Molise,41.55774754,14.65916051,51,9,60,2248,2308,157,1416,92,3816,76461
5702,11,21,ITA,21,P.A. Bolzano,46.49933453,11.35662422,450,39,489,11186,11675,548,8528,462,20665,143675
5703,11,21,ITA,22,P.A. Trento,46.06893511,11.12123097,413,40,453,2249,2702,212,10694,577,13973,127347
5704,11,21,ITA,1,Piemonte,45.0732745,7.680687483,5150,390,5540,70552,76092,2896,65346,5496,146934,890725
5705,11,21,ITA,16,Puglia,41.12559576,16.86736689,1432,197,1629,28791,30420,1377,10612,1148,42180,501346
5706,11,21,ITA,20,Sardegna,39.21531192,9.110616306,504,70,574,11340,11914,511,5796,379,18089,289864
5707,11,21,ITA,19,Sicilia,38.11569725,13.3623567,1568,242,1810,34431,36241,1838,14489,1141,51871,602679
5708,11,21,ITA,9,Toscana,43.76923077,11.25588885,1798,296,2094,51046,53140,1892,37471,2165,92776,904959
5709,11,21,ITA,10,Umbria,43.10675841,12.38824698,370,75,445,10978,11423,408,9623,323,21369,213635
5710,11,21,ITA,2,Valle d'Aosta,45.73750286,7.320149366,149,11,160,1841,2001,91,3641,281,5923,31251
5711,11,21,ITA,5,Veneto,45.43490485,12.33845213,2200,275,2475,68272,70747,3567,45789,3190,119726,1022442
5712,11,22,ITA,13,Abruzzo,42.35122196,13.39843823,664,72,736,15395,16131,560,6731,786,23648,221913
5713,11,22,ITA,17,Basilicata,40.63947052,15.80514834,156,23,179,5153,5332,208,1128,110,6570,138861
5714,11,22,ITA,18,Calabria,38.90597598,16.59440194,433,47,480,9578,10058,444,3616,222,13896,335526
5715,11,22,ITA,15,Campania,40.83956555,14.25084984,2218,201,2419,101062,103481,3217,31522,1270,136273,1002964
5716,11,22,ITA,8,Emilia-Romagna,44.49436681,11.3417208,2666,249,2915,64359,67274,2665,33105,5350,105729,1027297
5717,11,22,ITA,6,Friuli Venezia Giulia,45.6494354,13.76813649,545,56,601,12450,13051,675,10961,646,24658,264942
5718,11,22,ITA,12,Lazio,41.89277044,12.48366722,3298,339,3637,78416,82053,2533,18609,1978,102640,1636960
5719,11,22,ITA,7,Liguria,44.41149315,8.9326992,1253,122,1375,14503,15878,611,30008,2241,48127,279225
5720,11,22,ITA,3,Lombardia,45.46679409,9.190347404,8391,949,9340,155066,164406,5094,186680,20524,371610,2248813
5721,11,22,ITA,11,Marche,43.61675973,13.5188753,542,88,630,14737,15367,529,10047,1180,26594,227685
5722,11,22,ITA,14,Molise,41.55774754,14.65916051,51,11,62,2308,2370,93,1445,94,3909,77476
5723,11,22,ITA,21,P.A. Bolzano,46.49933453,11.35662422,453,38,491,11133,11624,535,9107,469,21200,144616
5724,11,22,ITA,22,P.A. Trento,46.06893511,11.12123097,420,41,461,2081,2542,159,11012,578,14132,128250
5725,11,22,ITA,1,Piemonte,45.0732745,7.680687483,5132,398,5530,71482,77012,2641,66998,5565,149575,898135
5726,11,22,ITA,16,Puglia,41.12559576,16.86736689,1449,188,1637,29715,31352,1327,10975,1180,43507,506049
5727,11,22,ITA,20,Sardegna,39.21531192,9.110616306,503,70,573,11610,12183,404,5921,389,18493,293328
5728,11,22,ITA,19,Sicilia,38.11569725,13.3623567,1597,241,1838,35324,37162,1258,14781,1186,53129,606566
5729,11,22,ITA,9,Toscana,43.76923077,11.25588885,1785,298,2083,50641,52724,1929,39765,2216,94705,912549
5730,11,22,ITA,10,Umbria,43.10675841,12.38824698,368,75,443,11129,11572,400,9864,333,21769,215754
5731,11,22,ITA,2,Valle d'Aosta,45.73750286,7.320149366,144,14,158,1761,1919,99,3818,285,6022,31620
5732,11,22,ITA,5,Veneto,45.43490485,12.33845213,2211,281,2492,69964,72456,2956,47005,3221,122682,1027321
5733,11,23,ITA,13,Abruzzo,42.35122196,13.39843823,672,71,743,15606,16349,640,7135,804,24288,223871
5734,11,23,ITA,17,Basilicata,40.63947052,15.80514834,157,23,180,5192,5372,58,1142,114,6628,139045
5735,11,23,ITA,18,Calabria,38.90597598,16.59440194,435,47,482,9664,10146,321,3832,239,14217,337422
5736,11,23,ITA,15,Campania,40.83956555,14.25084984,2331,201,2532,100977,103509,2158,33613,1309,138431,1009443
5737,11,23,ITA,8,Emilia-Romagna,44.49436681,11.3417208,2738,248,2986,66394,69380,2347,33309,5384,108073,1033714
5738,11,23,ITA,6,Friuli Venezia Giulia,45.6494354,13.76813649,565,55,620,12585,13205,377,11157,673,25035,265792
5739,11,23,ITA,12,Lazio,41.89277044,12.48366722,3351,335,3686,80203,83889,2341,19066,2026,104981,1653284
5740,11,23,ITA,7,Liguria,44.41149315,8.9326992,1248,122,1370,13951,15321,285,30830,2261,48412,280174
5741,11,23,ITA,3,Lombardia,45.46679409,9.190347404,8331,945,9276,140642,149918,5289,206317,20664,376899,2262985
5742,11,23,ITA,11,Marche,43.61675973,13.5188753,550,90,640,14822,15462,161,10105,1188,26755,228318
5743,11,23,ITA,14,Molise,41.55774754,14.65916051,57,10,67,2341,2408,91,1497,95,4000,78437
5744,11,23,ITA,21,P.A. Bolzano,46.49933453,11.35662422,473,38,511,11104,11615,260,9371,474,21460,145053
5745,11,23,ITA,22,P.A. Trento,46.06893511,11.12123097,433,43,476,2042,2518,93,11122,585,14225,128773
5746,11,23,ITA,1,Piemonte,45.0732745,7.680687483,5112,399,5511,71412,76923,1730,68736,5646,151305,907022
5747,11,23,ITA,16,Puglia,41.12559576,16.86736689,1499,191,1690,30289,31979,980,11288,1220,44487,507599
5748,11,23,ITA,20,Sardegna,39.21531192,9.110616306,512,72,584,11880,12464,505,6139,395,18998,295290
5749,11,23,ITA,19,Sicilia,38.11569725,13.3623567,1604,243,1847,36066,37913,1249,15238,1227,54378,611550
5750,11,23,ITA,9,Toscana,43.76923077,11.25588885,1832,296,2128,50291,52419,1323,41345,2264,96028,917080
5751,11,23,ITA,10,Umbria,43.10675841,12.38824698,371,78,449,10034,10483,105,11054,337,21874,215945
5752,11,23,ITA,2,Valle d'Aosta,45.73750286,7.320149366,146,13,159,1690,1849,77,3960,290,6099,31934
5753,11,23,ITA,5,Veneto,45.43490485,12.33845213,2280,290,2570,71157,73727,2540,48237,3258,125222,1030974
5754,11,24,ITA,13,Abruzzo,42.35122196,13.39843823,672,71,743,15913,16656,536,7344,822,24822,225989
5755,11,24,ITA,17,Basilicata,40.63947052,15.80514834,160,19,179,5412,5591,261,1168,130,6889,140861
5756,11,24,ITA,18,Calabria,38.90597598,16.59440194,429,42,471,9664,10135,307,4146,243,14524,340065
5757,11,24,ITA,15,Campania,40.83956555,14.25084984,2274,201,2475,100376,102851,1764,35957,1387,140195,1011680
5758,11,24,ITA,8,Emilia-Romagna,44.49436681,11.3417208,2723,243,2966,68378,71344,2501,33788,5439,110571,1041385
5759,11,24,ITA,6,Friuli Venezia Giulia,45.6494354,13.76813649,561,54,615,12732,13347,554,11543,699,25589,267036
5760,11,24,ITA,12,Lazio,41.89277044,12.48366722,3361,345,3706,82090,85796,2509,19606,2088,107490,1679178
5761,11,24,ITA,7,Liguria,44.41149315,8.9326992,1179,121,1300,13483,14783,509,31852,2286,48921,281926
5762,11,24,ITA,3,Lombardia,45.46679409,9.190347404,8360,932,9292,139468,148760,4886,212175,20850,381785,2274365
5763,11,24,ITA,11,Marche,43.61675973,13.5188753,555,89,644,15073,15717,351,10188,1201,27106,229538
5764,11,24,ITA,14,Molise,41.55774754,14.65916051,61,10,71,2388,2459,71,1516,96,4071,79053
5765,11,24,ITA,21,P.A. Bolzano,46.49933453,11.35662422,459,40,499,11157,11656,160,9474,490,21620,145395
5766,11,24,ITA,22,P.A. Trento,46.06893511,11.12123097,436,42,478,1994,2472,143,11297,599,14368,129600
5767,11,24,ITA,1,Piemonte,45.0732745,7.680687483,5116,404,5520,71555,77075,2070,70581,5719,153375,915304
5768,11,24,ITA,16,Puglia,41.12559576,16.86736689,1485,205,1690,31269,32959,1567,11823,1272,46054,515378
5769,11,24,ITA,20,Sardegna,39.21531192,9.110616306,527,73,600,11962,12562,290,6319,407,19288,297167
5770,11,24,ITA,19,Sicilia,38.11569725,13.3623567,1601,243,1844,36355,38199,1306,16210,1275,55684,617938
5771,11,24,ITA,9,Toscana,43.76923077,11.25588885,1771,296,2067,48639,50706,962,43973,2311,96990,922166
5772,11,24,ITA,10,Umbria,43.10675841,12.38824698,368,72,440,9757,10197,218,11548,347,22092,217537
5773,11,24,ITA,2,Valle d'Aosta,45.73750286,7.320149366,143,14,157,1610,1767,73,4113,292,6172,32193
5774,11,24,ITA,5,Veneto,45.43490485,12.33845213,2336,300,2636,70718,73354,2194,50709,3353,127416,1035198
5775,11,25,ITA,13,Abruzzo,42.35122196,13.39843823,676,72,748,16284,17032,623,7582,831,25445,228016
5776,11,25,ITA,17,Basilicata,40.63947052,15.80514834,154,22,176,5691,5867,329,1218,133,7218,143446
5777,11,25,ITA,18,Calabria,38.90597598,16.59440194,425,43,468,9796,10264,335,4345,250,14859,342655
5778,11,25,ITA,15,Campania,40.83956555,14.25084984,2282,192,2474,99674,102148,2815,39428,1434,143010,1028617
5779,11,25,ITA,8,Emilia-Romagna,44.49436681,11.3417208,2763,249,3012,69514,72526,2130,34681,5493,112700,1048727
5780,11,25,ITA,6,Friuli Venezia Giulia,45.6494354,13.76813649,588,54,642,12894,13536,696,12034,715,26285,268850
5781,11,25,ITA,12,Lazio,41.89277044,12.48366722,3348,349,3697,82868,86565,2102,20881,2146,109592,1703897
5782,11,25,ITA,7,Liguria,44.41149315,8.9326992,1115,123,1238,12817,14055,460,33018,2308,49381,283560
5783,11,25,ITA,3,Lombardia,45.46679409,9.190347404,8114,942,9056,128973,138029,5173,227924,21005,386958,2289221
5784,11,25,ITA,11,Marche,43.61675973,13.5188753,578,94,672,15359,16031,448,10312,1211,27554,231259
5785,11,25,ITA,14,Molise,41.55774754,14.65916051,66,10,76,2474,2550,106,1528,99,4177,80516
5786,11,25,ITA,21,P.A. Bolzano,46.49933453,11.35662422,442,41,483,11117,11600,341,9863,498,21961,146006
5787,11,25,ITA,22,P.A. Trento,46.06893511,11.12123097,421,41,462,1985,2447,179,11494,606,14547,130165
5788,11,25,ITA,1,Piemonte,45.0732745,7.680687483,5095,403,5498,72423,77921,2878,72529,5803,156253,923880
5789,11,25,ITA,16,Puglia,41.12559576,16.86736689,1483,210,1693,32378,34071,1511,12192,1302,47565,518776
5790,11,25,ITA,20,Sardegna,39.21531192,9.110616306,515,76,591,12106,12697,351,6529,413,19639,300076
5791,11,25,ITA,19,Sicilia,38.11569725,13.3623567,1574,250,1824,36496,38320,1317,17359,1322,57001,625213
5792,11,25,ITA,9,Toscana,43.76923077,11.25588885,1754,286,2040,47240,49280,986,46318,2378,97976,928848
5793,11,25,ITA,10,Umbria,43.10675841,12.38824698,361,70,431,9506,9937,386,12186,355,22478,219242
5794,11,25,ITA,2,Valle d'Aosta,45.73750286,7.320149366,137,16,153,1530,1683,27,4219,297,6199,32389
5795,11,25,ITA,5,Veneto,45.43490485,12.33845213,2422,305,2727,72411,75138,2660,51509,3429,130076,1039770
5796,11,26,ITA,13,Abruzzo,42.35122196,13.39843823,694,74,768,16566,17334,570,7830,851,26015,229937
5797,11,26,ITA,17,Basilicata,40.63947052,15.80514834,156,22,178,5922,6100,236,1218,136,7454,145411
5798,11,26,ITA,18,Calabria,38.90597598,16.59440194,428,45,473,9993,10466,397,4536,254,15256,344984
5799,11,26,ITA,15,Campania,40.83956555,14.25084984,2212,200,2412,100972,103384,3008,41151,1483,146018,1039969
5800,11,26,ITA,8,Emilia-Romagna,44.49436681,11.3417208,2679,258,2937,68535,71472,2157,37835,5548,114855,1055046
5801,11,26,ITA,6,Friuli Venezia Giulia,45.6494354,13.76813649,599,55,654,13168,13822,814,12536,741,27099,270753
5802,11,26,ITA,12,Lazio,41.89277044,12.48366722,3408,352,3760,83543,87303,2260,22334,2215,111852,1726408
5803,11,26,ITA,7,Liguria,44.41149315,8.9326992,1075,114,1189,12303,13492,570,34137,2322,49951,285519
5804,11,26,ITA,3,Lombardia,45.46679409,9.190347404,7996,934,8930,131471,140401,5697,231042,21212,392655,2304509
5805,11,26,ITA,11,Marche,43.61675973,13.5188753,586,90,676,15733,16409,519,10443,1221,28073,233374
5806,11,26,ITA,14,Molise,41.55774754,14.65916051,69,9,78,2574,2652,108,1530,103,4285,81426
5807,11,26,ITA,21,P.A. Bolzano,46.49933453,11.35662422,434,40,474,10976,11450,292,10294,509,22253,146515
5808,11,26,ITA,22,P.A. Trento,46.06893511,11.12123097,417,43,460,1902,2362,297,11867,615,14844,131463
5809,11,26,ITA,1,Piemonte,45.0732745,7.680687483,4992,403,5395,73011,78406,2751,74723,5875,159004,933365
5810,11,26,ITA,16,Puglia,41.12559576,16.86736689,1577,211,1788,33191,34979,1436,12668,1354,49001,524389
5811,11,26,ITA,20,Sardegna,39.21531192,9.110616306,535,73,608,12363,12971,405,6655,418,20044,302707
5812,11,26,ITA,19,Sicilia,38.11569725,13.3623567,1545,253,1798,36710,38508,1768,18890,1371,58769,632415
5813,11,26,ITA,9,Toscana,43.76923077,11.25588885,1712,281,1993,46142,48135,1351,48742,2450,99327,935992
5814,11,26,ITA,10,Umbria,43.10675841,12.38824698,349,68,417,9017,9434,343,13018,369,22821,220882
5815,11,26,ITA,2,Valle d'Aosta,45.73750286,7.320149366,128,17,145,1468,1613,44,4328,302,6243,32671
5816,11,26,ITA,5,Veneto,45.43490485,12.33845213,2447,304,2751,72401,75152,3980,55403,3501,134056,1045655
5817,11,27,ITA,13,Abruzzo,42.35122196,13.39843823,689,74,763,16797,17560,510,8097,868,26525,231706
5818,11,27,ITA,17,Basilicata,40.63947052,15.80514834,153,23,176,5789,5965,218,1559,139,7663,147124
5819,11,27,ITA,18,Calabria,38.90597598,16.59440194,432,44,476,10346,10822,468,4643,259,15724,347932
5820,11,27,ITA,15,Campania,40.83956555,14.25084984,2188,184,2372,101610,103982,2924,43414,1546,148942,1054566
5821,11,27,ITA,8,Emilia-Romagna,44.49436681,11.3417208,2673,250,2923,67366,70289,2165,41116,5614,117019,1061899
5822,11,27,ITA,6,Friuli Venezia Giulia,45.6494354,13.76813649,594,55,649,13606,14255,864,12932,776,27963,272700
5823,11,27,ITA,12,Lazio,41.89277044,12.48366722,3407,355,3762,84172,87934,2276,23910,2284,114128,1743866
5824,11,27,ITA,7,Liguria,44.41149315,8.9326992,1019,109,1128,11883,13011,606,35210,2336,50557,287369
5825,11,27,ITA,3,Lombardia,45.46679409,9.190347404,7869,925,8794,121761,130555,5389,246096,21393,398044,2319630
5826,11,27,ITA,11,Marche,43.61675973,13.5188753,564,91,655,16188,16843,490,10490,1230,28563,235330
5827,11,27,ITA,14,Molise,41.55774754,14.65916051,62,11,73,2552,2625,79,1631,108,4364,82288
5828,11,27,ITA,21,P.A. Bolzano,46.49933453,11.35662422,414,42,456,11027,11483,410,10660,520,22663,147068
5829,11,27,ITA,22,P.A. Trento,46.06893511,11.12123097,408,44,452,1857,2309,229,12141,623,15073,132813
5830,11,27,ITA,1,Piemonte,45.0732745,7.680687483,4922,395,5317,72272,77589,3149,78592,5972,162153,942459
5831,11,27,ITA,16,Puglia,41.12559576,16.86736689,1654,201,1855,34562,36417,1737,12919,1402,50738,529720
5832,11,27,ITA,20,Sardegna,39.21531192,9.110616306,528,71,599,12556,13155,375,6837,427,20419,305590
5833,11,27,ITA,19,Sicilia,38.11569725,13.3623567,1539,250,1789,37294,39083,1566,19834,1418,60335,639257
5834,11,27,ITA,9,Toscana,43.76923077,11.25588885,1647,278,1925,44606,46531,1117,51397,2516,100444,942239
5835,11,27,ITA,10,Umbria,43.10675841,12.38824698,353,62,415,8635,9050,261,13649,383,23082,222157
5836,11,27,ITA,2,Valle d'Aosta,45.73750286,7.320149366,129,15,144,1403,1547,101,4495,302,6344,33067
5837,11,27,ITA,5,Veneto,45.43490485,12.33845213,2440,303,2743,74145,76888,3418,57025,3561,137474,1050631
5838,11,28,ITA,13,Abruzzo,42.35122196,13.39843823,680,77,757,17005,17762,532,8415,879,27056,233698
5839,11,28,ITA,17,Basilicata,40.63947052,15.80514834,142,22,164,5909,6073,215,1663,142,7878,148712
5840,11,28,ITA,18,Calabria,38.90597598,16.59440194,410,42,452,10532,10984,426,4894,272,16150,350706
5841,11,28,ITA,15,Campania,40.83956555,14.25084984,2164,186,2350,102033,104383,2729,45693,1595,151671,1068940
5842,11,28,ITA,8,Emilia-Romagna,44.49436681,11.3417208,2673,245,2918,66865,69783,2172,43717,5684,119184,1068411
5843,11,28,ITA,6,Friuli Venezia Giulia,45.6494354,13.76813649,604,53,657,13339,13996,1432,14598,801,29395,278729
5844,11,28,ITA,12,Lazio,41.89277044,12.48366722,3352,356,3708,85554,89262,2070,24627,2309,116198,1766817
5845,11,28,ITA,7,Liguria,44.41149315,8.9326992,968,117,1085,11640,12725,454,35925,2361,51011,288865
5846,11,28,ITA,3,Lombardia,45.46679409,9.190347404,7616,919,8535,121780,130315,4615,250832,21512,402659,2333345
5847,11,28,ITA,11,Marche,43.61675973,13.5188753,571,85,656,16587,17243,473,10551,1242,29036,236940
5848,11,28,ITA,14,Molise,41.55774754,14.65916051,59,12,71,2526,2597,148,1802,113,4512,83568
5849,11,28,ITA,21,P.A. Bolzano,46.49933453,11.35662422,409,36,445,11113,11558,494,11076,523,23157,147600
5850,11,28,ITA,22,P.A. Trento,46.06893511,11.12123097,404,42,446,1687,2133,219,12530,629,15292,134489
5851,11,28,ITA,1,Piemonte,45.0732745,7.680687483,4781,384,5165,70912,76077,2157,82163,6070,164310,950345
5852,11,28,ITA,16,Puglia,41.12559576,16.86736689,1675,200,1875,35779,37654,1573,13225,1432,52311,536605
5853,11,28,ITA,20,Sardegna,39.21531192,9.110616306,544,73,617,12502,13119,311,7179,432,20730,308816
5854,11,28,ITA,19,Sicilia,38.11569725,13.3623567,1519,247,1766,38116,39882,1189,20181,1461,61524,644441
5855,11,28,ITA,9,Toscana,43.76923077,11.25588885,1593,279,1872,43200,45072,1196,54005,2563,101640,948551
5856,11,28,ITA,10,Umbria,43.10675841,12.38824698,351,64,415,8238,8653,348,14388,389,23430,223404
5857,11,28,ITA,2,Valle d'Aosta,45.73750286,7.320149366,130,14,144,1321,1465,72,4641,310,6416,33335
5858,11,28,ITA,5,Veneto,45.43490485,12.33845213,2654,309,2963,75609,78572,3498,58756,3644,140972,1055933
5859,11,29,ITA,13,Abruzzo,42.35122196,13.39843823,659,75,734,17306,18040,413,8543,886,27469,235487
5860,11,29,ITA,17,Basilicata,40.63947052,15.80514834,141,25,166,6016,6182,172,1723,145,8050,150157
5861,11,29,ITA,18,Calabria,38.90597598,16.59440194,405,43,448,10576,11024,294,5139,281,16444,353026
5862,11,29,ITA,15,Campania,40.83956555,14.25084984,2165,183,2348,102438,104786,2022,47276,1631,153693,1076585
5863,11,29,ITA,8,Emilia-Romagna,44.49436681,11.3417208,2668,245,2913,67316,70229,1850,45089,5714,121032,1074568
5864,11,29,ITA,6,Friuli Venezia Giulia,45.6494354,13.76813649,620,57,677,13632,14309,680,14949,817,30075,280065
5865,11,29,ITA,12,Lazio,41.89277044,12.48366722,3358,355,3713,85999,89712,1993,26151,2328,118191,1784328
5866,11,29,ITA,7,Liguria,44.41149315,8.9326992,970,111,1081,11525,12606,437,36462,2380,51448,290019
5867,11,29,ITA,3,Lombardia,45.46679409,9.190347404,7400,907,8307,124320,132627,3203,251588,21647,405862,2343093
5868,11,29,ITA,11,Marche,43.61675973,13.5188753,598,85,683,17013,17696,518,10603,1255,29554,238861
5869,11,29,ITA,14,Molise,41.55774754,14.65916051,61,13,74,2571,2645,114,1864,117,4626,84436
5870,11,29,ITA,21,P.A. Bolzano,46.49933453,11.35662422,420,36,456,10881,11337,437,11727,530,23594,148650
5871,11,29,ITA,22,P.A. Trento,46.06893511,11.12123097,404,44,448,1871,2319,265,12597,641,15557,135008
5872,11,29,ITA,1,Piemonte,45.0732745,7.680687483,4734,385,5119,71865,76984,2021,83193,6154,166331,956383
5873,11,29,ITA,16,Puglia,41.12559576,16.86736689,1675,212,1887,36357,38244,907,13521,1453,53218,538195
5874,11,29,ITA,20,Sardegna,39.21531192,9.110616306,554,69,623,12776,13399,416,7311,436,21146,310882
5875,11,29,ITA,19,Sicilia,38.11569725,13.3623567,1522,241,1763,38721,40484,1024,20558,1506,62548,649920
5876,11,29,ITA,9,Toscana,43.76923077,11.25588885,1590,278,1868,41676,43544,908,56403,2601,102548,954647
5877,11,29,ITA,10,Umbria,43.10675841,12.38824698,355,65,420,8023,8443,310,14903,394,23740,224573
5878,11,29,ITA,2,Valle d'Aosta,45.73750286,7.320149366,138,13,151,1299,1450,47,4702,311,6463,33672
5879,11,29,ITA,5,Veneto,45.43490485,12.33845213,2442,311,2753,76958,79711,2617,60201,3677,143589,1059827
5880,11,30,ITA,13,Abruzzo,42.35122196,13.39843823,714,76,790,17402,18192,556,8939,893,28024,237280
5881,11,30,ITA,17,Basilicata,40.63947052,15.80514834,150,22,172,6020,6192,92,1797,153,8142,150830
5882,11,30,ITA,18,Calabria,38.90597598,16.59440194,400,42,442,10528,10970,270,5449,295,16714,354571
5883,11,30,ITA,15,Campania,40.83956555,14.25084984,2141,182,2323,102204,104527,1626,49119,1673,155319,1083728
5884,11,30,ITA,8,Emilia-Romagna,44.49436681,11.3417208,2755,249,3004,68730,71734,2041,45586,5753,123073,1079854
5885,11,30,ITA,6,Friuli Venezia Giulia,45.6494354,13.76813649,633,55,688,13827,14515,575,15297,838,30650,281701
5886,11,30,ITA,12,Lazio,41.89277044,12.48366722,3384,350,3734,86467,90201,1589,27212,2367,119780,1799351
5887,11,30,ITA,7,Liguria,44.41149315,8.9326992,997,113,1110,11106,12216,236,37081,2387,51684,290739
5888,11,30,ITA,3,Lombardia,45.46679409,9.190347404,7433,906,8339,117069,125408,1929,260528,21855,407791,2349286
5889,11,30,ITA,11,Marche,43.61675973,13.5188753,585,87,672,17244,17916,252,10626,1264,29806,239816
5890,11,30,ITA,14,Molise,41.55774754,14.65916051,62,14,76,2644,2720,87,1875,118,4713,85198
5891,11,30,ITA,21,P.A. Bolzano,46.49933453,11.35662422,428,37,465,10857,11322,183,11924,531,23777,149001
5892,11,30,ITA,22,P.A. Trento,46.06893511,11.12123097,415,44,459,1989,2448,176,12631,654,15733,135274
5893,11,30,ITA,1,Piemonte,45.0732745,7.680687483,4737,388,5125,69818,74943,1185,86334,6239,167516,961035
5894,11,30,ITA,16,Puglia,41.12559576,16.86736689,1692,209,1901,36871,38772,1102,14065,1483,54320,541174
5895,11,30,ITA,20,Sardegna,39.21531192,9.110616306,580,70,650,12878,13528,329,7503,444,21475,313019
5896,11,30,ITA,19,Sicilia,38.11569725,13.3623567,1547,226,1773,38851,40624,1138,21507,1555,63686,654885
5897,11,30,ITA,9,Toscana,43.76923077,11.25588885,1584,278,1862,40164,42026,893,58774,2641,103441,958389
5898,11,30,ITA,10,Umbria,43.10675841,12.38824698,366,65,431,7804,8235,68,15166,407,23808,224790
5899,11,30,ITA,2,Valle d'Aosta,45.73750286,7.320149366,124,11,135,1182,1317,47,4878,315,6510,33903
5900,11,30,ITA,5,Veneto,45.43490485,12.33845213,2460,320,2780,77885,80665,2003,61216,3711,145592,1062810
5901,12,1,ITA,13,Abruzzo,42.35122196,13.39843823,697,76,773,17415,18188,396,9326,906,28420,238795
5902,12,1,ITA,17,Basilicata,40.63947052,15.80514834,157,21,178,6102,6280,156,1865,153,8298,152306
5903,12,1,ITA,18,Calabria,38.90597598,16.59440194,417,40,457,10512,10969,318,5762,301,17032,356721
5904,12,1,ITA,15,Campania,40.83956555,14.25084984,2099,179,2278,100601,102879,1113,51832,1721,156432,1087947
5905,12,1,ITA,8,Emilia-Romagna,44.49436681,11.3417208,2729,247,2976,68866,71842,1471,46894,5805,124541,1085200
5906,12,1,ITA,6,Friuli Venezia Giulia,45.6494354,13.76813649,637,62,699,13769,14468,736,16055,863,31386,284047
5907,12,1,ITA,12,Lazio,41.89277044,12.48366722,3241,352,3593,87345,90938,1669,28080,2431,121449,1823889
5908,12,1,ITA,7,Liguria,44.41149315,8.9326992,1003,105,1108,11042,12150,339,37469,2404,52023,292065
5909,12,1,ITA,3,Lombardia,45.46679409,9.190347404,7342,876,8218,112815,121033,4048,268702,22104,411839,2361598
5910,12,1,ITA,11,Marche,43.61675973,13.5188753,586,86,672,17532,18204,337,10663,1276,30143,241029
5911,12,1,ITA,14,Molise,41.55774754,14.65916051,64,13,77,2634,2711,60,1942,120,4773,85853
5912,12,1,ITA,21,P.A. Bolzano,46.49933453,11.35662422,414,34,448,10851,11299,94,12038,534,23871,149245
5913,12,1,ITA,22,P.A. Trento,46.06893511,11.12123097,406,44,450,2000,2450,156,12777,662,15889,136084
5914,12,1,ITA,1,Piemonte,45.0732745,7.680687483,4652,377,5029,67240,72269,1617,90561,6303,169133,966274
5915,12,1,ITA,16,Puglia,41.12559576,16.86736689,1693,218,1911,37855,39766,1659,14696,1517,55979,545066
5916,12,1,ITA,20,Sardegna,39.21531192,9.110616306,583,68,651,12975,13626,420,7820,449,21895,315735
5917,12,1,ITA,19,Sicilia,38.11569725,13.3623567,1517,220,1737,38993,40730,1399,22766,1589,65085,661271
5918,12,1,ITA,9,Toscana,43.76923077,11.25588885,1563,267,1830,38371,40201,658,61225,2673,104099,961774
5919,12,1,ITA,10,Umbria,43.10675841,12.38824698,361,64,425,7255,7680,144,15857,415,23952,226025
5920,12,1,ITA,2,Valle d'Aosta,45.73750286,7.320149366,123,13,136,1129,1265,25,4953,317,6535,34026
5921,12,1,ITA,5,Veneto,45.43490485,12.33845213,2527,301,2828,78169,80997,2535,63312,3818,148127,1066796
5922,12,2,ITA,13,Abruzzo,42.35122196,13.39843823,703,74,777,17207,17984,381,9890,927,28801,240318
5923,12,2,ITA,17,Basilicata,40.63947052,15.80514834,158,21,179,6178,6357,157,1945,153,8455,154082
5924,12,2,ITA,18,Calabria,38.90597598,16.59440194,411,36,447,10443,10890,230,6062,310,17262,359679
5925,12,2,ITA,15,Campania,40.83956555,14.25084984,2064,173,2237,100258,102495,1842,54015,1764,158274,1100911
5926,12,2,ITA,8,Emilia-Romagna,44.49436681,11.3417208,2692,247,2939,68366,71305,1569,48931,5874,126110,1091519
5927,12,2,ITA,6,Friuli Venezia Giulia,45.6494354,13.76813649,652,58,710,13983,14693,812,16616,889,32198,286147
5928,12,2,ITA,12,Lazio,41.89277044,12.48366722,3282,350,3632,88272,91904,1791,28860,2476,123240,1843535
5929,12,2,ITA,7,Liguria,44.41149315,8.9326992,963,102,1065,10934,11999,349,37950,2423,52372,293385
5930,12,2,ITA,3,Lombardia,45.46679409,9.190347404,7222,855,8077,110719,118796,3425,274189,22279,415264,2372367
5931,12,2,ITA,11,Marche,43.61675973,13.5188753,565,85,650,17919,18569,421,10706,1289,30564,242628
5932,12,2,ITA,14,Molise,41.55774754,14.65916051,65,9,74,2509,2583,95,2158,127,4868,86650
5933,12,2,ITA,21,P.A. Bolzano,46.49933453,11.35662422,416,33,449,10880,11329,317,12317,542,24188,149819
5934,12,2,ITA,22,P.A. Trento,46.06893511,11.12123097,412,47,459,2000,2459,278,13043,665,16167,137151
5935,12,2,ITA,1,Piemonte,45.0732745,7.680687483,4596,382,4978,65909,70887,1568,93454,6360,170701,971526
5936,12,2,ITA,16,Puglia,41.12559576,16.86736689,1685,204,1889,38871,40760,1668,15341,1546,57647,552400
5937,12,2,ITA,20,Sardegna,39.21531192,9.110616306,577,66,643,13240,13883,445,8004,453,22340,318301
5938,12,2,ITA,19,Sicilia,38.11569725,13.3623567,1494,220,1714,38017,39731,1483,25221,1616,66568,668442
5939,12,2,ITA,9,Toscana,43.76923077,11.25588885,1514,271,1785,35740,37525,776,64632,2718,104875,966235
5940,12,2,ITA,10,Umbria,43.10675841,12.38824698,342,62,404,6679,7083,278,16722,425,24230,227246
5941,12,2,ITA,2,Valle d'Aosta,45.73750286,7.320149366,122,13,135,1071,1206,42,5049,322,6577,34160
5942,12,2,ITA,5,Veneto,45.43490485,12.33845213,2519,308,2827,65965,68792,2782,78230,3887,150909,1070844
5943,12,3,ITA,13,Abruzzo,42.35122196,13.39843823,698,76,774,17054,17828,395,10428,940,29196,241874
5944,12,3,ITA,17,Basilicata,40.63947052,15.80514834,161,20,181,6224,6405,131,2023,158,8586,155787
5945,12,3,ITA,18,Calabria,38.90597598,16.59440194,399,32,431,10160,10591,280,6629,322,17542,362057
5946,12,3,ITA,15,Campania,40.83956555,14.25084984,2041,162,2203,100371,102574,2295,56177,1818,160569,1118787
5947,12,3,ITA,8,Emilia-Romagna,44.49436681,11.3417208,2668,245,2913,67324,70237,1766,51674,5959,127870,1097761
5948,12,3,ITA,6,Friuli Venezia Giulia,45.6494354,13.76813649,629,59,688,14195,14883,772,17146,941,32970,290494
5949,12,3,ITA,12,Lazio,41.89277044,12.48366722,3233,364,3597,89282,92879,1769,29616,2514,125009,1852335
5950,12,3,ITA,7,Liguria,44.41149315,8.9326992,932,102,1034,10424,11458,422,38887,2449,52794,294667
5951,12,3,ITA,3,Lombardia,45.46679409,9.190347404,7025,836,7861,110470,118331,3751,278058,22626,419015,2383936
5952,12,3,ITA,11,Marche,43.61675973,13.5188753,526,88,614,18335,18949,476,10793,1298,31040,244290
5953,12,3,ITA,14,Molise,41.55774754,14.65916051,65,10,75,2357,2432,53,2362,127,4921,87258
5954,12,3,ITA,21,P.A. Bolzano,46.49933453,11.35662422,428,35,463,10752,11215,374,12789,558,24562,150436
5955,12,3,ITA,22,P.A. Trento,46.06893511,11.12123097,404,45,449,2083,2532,239,13200,674,16406,138153
5956,12,3,ITA,1,Piemonte,45.0732745,7.680687483,4459,366,4825,65181,70006,2230,96473,6452,172931,982816
5957,12,3,ITA,16,Puglia,41.12559576,16.86736689,1621,226,1847,39902,41749,1602,15912,1588,59249,555325
5958,12,3,ITA,20,Sardegna,39.21531192,9.110616306,593,66,659,13561,14220,538,8196,462,22878,323045
5959,12,3,ITA,19,Sicilia,38.11569725,13.3623567,1465,221,1686,38094,39780,1294,26432,1650,67862,674771
5960,12,3,ITA,9,Toscana,43.76923077,11.25588885,1467,272,1739,33691,35430,929,67618,2756,105804,971080
5961,12,3,ITA,10,Umbria,43.10675841,12.38824698,344,54,398,6364,6762,286,17314,440,24516,228438
5962,12,3,ITA,2,Valle d'Aosta,45.73750286,7.320149366,113,11,124,994,1118,42,5177,324,6619,34276
5963,12,3,ITA,5,Veneto,45.43490485,12.33845213,2501,307,2808,67795,70603,3581,79905,3982,154490,1077351
5964,12,4,ITA,13,Abruzzo,42.35122196,13.39843823,700,73,773,17019,17792,408,10857,955,29604,243415
5965,12,4,ITA,17,Basilicata,40.63947052,15.80514834,165,20,185,6259,6444,142,2123,161,8728,157503
5966,12,4,ITA,18,Calabria,38.90597598,16.59440194,390,34,424,10151,10575,335,6987,329,17891,364826
5967,12,4,ITA,15,Campania,40.83956555,14.25084984,1999,166,2165,99691,101856,1651,58461,1903,162220,1132418
5968,12,4,ITA,8,Emilia-Romagna,44.49436681,11.3417208,2717,248,2965,67091,70056,2143,53931,6022,130009,1103704
5969,12,4,ITA,6,Friuli Venezia Giulia,45.6494354,13.76813649,632,59,691,14482,15173,1040,17860,977,34010,293200
5970,12,4,ITA,12,Lazio,41.89277044,12.48366722,3178,360,3538,90299,93837,1831,30427,2576,126840,1852335
5971,12,4,ITA,7,Liguria,44.41149315,8.9326992,912,99,1011,10016,11027,367,39660,2474,53161,296122
5972,12,4,ITA,3,Lombardia,45.46679409,9.190347404,6792,822,7614,109088,116702,4533,284073,22773,423548,2397885
5973,12,4,ITA,11,Marche,43.61675973,13.5188753,518,87,605,18756,19361,492,10866,1305,31532,247137
5974,12,4,ITA,14,Molise,41.55774754,14.65916051,64,10,74,2531,2605,176,2364,129,5098,88626
5975,12,4,ITA,21,P.A. Bolzano,46.49933453,11.35662422,418,32,450,10736,11186,285,13092,569,24847,151045
5976,12,4,ITA,22,P.A. Trento,46.06893511,11.12123097,415,47,462,2044,2506,255,13475,680,16661,139155
5977,12,4,ITA,1,Piemonte,45.0732745,7.680687483,4351,357,4708,63768,68476,2132,100081,6506,175063,990479
5978,12,4,ITA,16,Puglia,41.12559576,16.86736689,1596,227,1823,40721,42544,1419,16464,1660,60668,561954
5979,12,4,ITA,20,Sardegna,39.21531192,9.110616306,591,70,661,13840,14501,551,8417,511,23429,327023
5980,12,4,ITA,19,Sicilia,38.11569725,13.3623567,1431,216,1647,37703,39350,1365,28188,1689,69227,680641
5981,12,4,ITA,9,Toscana,43.76923077,11.25588885,1418,263,1681,31598,33279,1071,70798,2798,106875,975232
5982,12,4,ITA,10,Umbria,43.10675841,12.38824698,327,57,384,6039,6423,168,17817,444,24684,229396
5983,12,4,ITA,2,Valle d'Aosta,45.73750286,7.320149366,109,11,120,960,1080,27,5240,326,6646,34374
5984,12,4,ITA,5,Veneto,45.43490485,12.33845213,2477,309,2786,70143,72929,3708,81204,4065,158198,1081598
5985,12,5,ITA,13,Abruzzo,42.35122196,13.39843823,675,73,748,16499,17247,376,11764,969,29980,245073
5986,12,5,ITA,17,Basilicata,40.63947052,15.80514834,134,19,153,6259,6412,131,2278,169,8859,158895
5987,12,5,ITA,18,Calabria,38.90597598,16.59440194,379,29,408,10254,10662,306,7196,339,18197,367635
5988,12,5,ITA,15,Campania,40.83956555,14.25084984,1558,165,1723,99638,101361,1521,60422,1958,163741,1144454
5989,12,5,ITA,8,Emilia-Romagna,44.49436681,11.3417208,2707,243,2950,66679,69629,1964,56270,6074,131973,1109844
5990,12,5,ITA,6,Friuli Venezia Giulia,45.6494354,13.76813649,640,58,698,14366,15064,755,18693,1008,34765,295536
5991,12,5,ITA,12,Lazio,41.89277044,12.48366722,3075,349,3424,90055,93479,1783,32536,2608,128623,1867721
5992,12,5,ITA,7,Liguria,44.41149315,8.9326992,897,93,990,9528,10518,314,40456,2501,53475,297122
5993,12,5,ITA,3,Lombardia,45.46679409,9.190347404,6554,805,7359,108397,115756,3148,288056,22884,426696,2407249
5994,12,5,ITA,11,Marche,43.61675973,13.5188753,506,84,590,19108,19698,418,10938,1314,31950,250652
5995,12,5,ITA,14,Molise,41.55774754,14.65916051,61,9,70,2615,2685,152,2432,133,5250,89725
5996,12,5,ITA,21,P.A. Bolzano,46.49933453,11.35662422,410,31,441,10671,11112,266,13429,572,25113,151590
5997,12,5,ITA,22,P.A. Trento,46.06893511,11.12123097,404,48,452,2067,2519,226,13679,689,16887,140064
5998,12,5,ITA,1,Piemonte,45.0732745,7.680687483,4276,366,4642,62121,66763,1456,103188,6568,176519,996658
5999,12,5,ITA,16,Puglia,41.12559576,16.86736689,1576,220,1796,42364,44160,1884,16704,1688,62552,565942
6000,12,5,ITA,20,Sardegna,39.21531192,9.110616306,607,67,674,14183,14857,464,8512,524,23893,329682
6001,12,5,ITA,19,Sicilia,38.11569725,13.3623567,1400,215,1615,37925,39540,1240,29204,1723,70467,687039
6002,12,5,ITA,9,Toscana,43.76923077,11.25588885,1373,261,1634,28910,30544,769,74261,2839,107644,979295
6003,12,5,ITA,10,Umbria,43.10675841,12.38824698,330,61,391,5758,6149,226,18310,451,24910,230476
6004,12,5,ITA,2,Valle d'Aosta,45.73750286,7.320149366,107,9,116,940,1056,46,5306,330,6692,34511
6005,12,5,ITA,5,Veneto,45.43490485,12.33845213,2489,312,2801,72157,74958,3607,82674,4173,161805,1086461
6006,12,6,ITA,13,Abruzzo,42.35122196,13.39843823,667,71,738,16350,17088,294,12206,980,30274,246492
6007,12,6,ITA,17,Basilicata,40.63947052,15.80514834,119,18,137,6231,6368,81,2397,175,8940,160485
6008,12,6,ITA,18,Calabria,38.90597598,16.59440194,390,32,422,10239,10661,340,7533,343,18537,370059
6009,12,6,ITA,15,Campania,40.83956555,14.25084984,1916,155,2071,99172,101243,1552,62060,1990,165293,1153658
6010,12,6,ITA,8,Emilia-Romagna,44.49436681,11.3417208,2736,241,2977,65190,68167,1788,59432,6162,133761,1115823
6011,12,6,ITA,6,Friuli Venezia Giulia,45.6494354,13.76813649,652,59,711,14320,15031,702,19401,1035,35467,296752
6012,12,6,ITA,12,Lazio,41.89277044,12.48366722,3136,340,3476,90735,94211,1632,33422,2622,130255,1882721
6013,12,6,ITA,7,Liguria,44.41149315,8.9326992,868,92,960,9456,10416,304,40842,2521,53779,298052
6014,12,6,ITA,3,Lombardia,45.46679409,9.190347404,6372,807,7179,109200,116379,2413,289706,23024,429109,2415099
6015,12,6,ITA,11,Marche,43.61675973,13.5188753,518,82,600,19458,20058,443,11008,1327,32393,253076
6016,12,6,ITA,14,Molise,41.55774754,14.65916051,56,10,66,2647,2713,36,2438,135,5286,90383
6017,12,6,ITA,21,P.A. Bolzano,46.49933453,11.35662422,410,32,442,10479,10921,248,13862,578,25361,152109
6018,12,6,ITA,22,P.A. Trento,46.06893511,11.12123097,414,48,462,1955,2417,216,13995,691,17103,141146
6019,12,6,ITA,1,Piemonte,45.0732745,7.680687483,4239,359,4598,61440,66038,1269,105127,6623,177788,1000611
6020,12,6,ITA,16,Puglia,41.12559576,16.86736689,1613,203,1816,44018,45834,1789,16795,1712,64341,567857
6021,12,6,ITA,20,Sardegna,39.21531192,9.110616306,616,64,680,14280,14960,293,8695,531,24186,333552
6022,12,6,ITA,19,Sicilia,38.11569725,13.3623567,1367,213,1580,38166,39746,1022,29984,1759,71489,692062
6023,12,6,ITA,9,Toscana,43.76923077,11.25588885,1360,252,1612,27587,29199,753,76331,2867,108397,983103
6024,12,6,ITA,10,Umbria,43.10675841,12.38824698,332,60,392,5673,6065,234,18619,460,25144,231538
6025,12,6,ITA,2,Valle d'Aosta,45.73750286,7.320149366,102,8,110,877,987,34,5406,333,6726,34644
6026,12,6,ITA,5,Veneto,45.43490485,12.33845213,2508,308,2816,73988,76804,3444,84235,4210,165249,1090932
